Id,MarketPlaceValuation,MarketPlaceOffer,MarketPlaceEGP,DirectValuation,DirectOffer,DirectEGP,GrossProfit,Type
3362934,100,0,50,165,115,50,50,Direct
3375351,250,55,35,115,80,35,35,Direct
3358071,200,10,35,165,130,35,35,Direct
3374254,100,0,50,205,155,50,50,Direct
3377612,325,125,50,285,235,50,50,Direct
3310329,175,0,35,100,65,35,35,Direct
3374561,150,0,20,175,155,20,20,Direct
3268511,125,0,35,150,115,35,35,Direct
3360975,225,30,50,280,230,50,50,Direct
3389003,325,90,75,385,310,75,75,Direct
3392562,625,255,370,955,585,370,370,Direct
3404028,100,0,35,175,140,35,35,Direct
3355796,75,0,35,175,140,35,35,Direct
3411133,100,0,33,108,75,33,33,Direct
3413907,200,10,35,150,115,35,35,Direct
3415592,225,35,35,240,205,35,35,Direct
3399543,150,0,35,155,120,35,35,Direct
3403938,100,0,0,5,5,0,0,Direct
3416587,100,0,35,225,190,35,35,Direct
3417306,200,15,50,280,230,50,50,Direct
3419813,325,70,20,160,140,20,20,Direct
3384019,250,55,36,116,80,36,36,Direct
3408003,125,0,35,140,105,35,35,Direct
3420410,100,0,50,280,230,50,50,Direct
3420546,225,35,35,260,225,35,35,Direct
3418781,225,15,50,200,150,50,50,Direct
3426844,125,0,35,225,190,35,35,Direct
3388551,150,0,35,155,120,35,35,Direct
3403242,50,0,35,140,105,35,35,Direct
3405765,150,0,35,185,150,35,35,Direct
3407488,225,35,35,250,215,35,35,Direct
3408122,150,0,35,130,95,35,35,Direct
3412602,75,0,35,245,210,35,35,Direct
3413738,25,0,35,225,190,35,35,Direct
3414325,100,0,33,158,125,33,33,Direct
3424836,100,0,35,260,225,35,35,Direct
3396838,225,30,35,135,100,35,35,Direct
3406989,50,0,35,160,125,35,35,Direct
3409440,150,0,20,80,60,20,20,Direct
3412171,225,30,50,325,275,50,50,Direct
3412682,425,120,35,195,160,35,35,Direct
3412750,100,0,35,225,190,35,35,Direct
3416719,275,85,35,275,240,35,35,Direct
3423212,200,0,50,325,275,50,50,Direct
3393410,250,60,22,87,65,22,22,Direct
3394777,500,175,75,340,265,75,75,Direct
3399843,225,35,35,125,90,35,35,Direct
3404737,400,145,50,200,150,50,50,Direct
3382475,75,0,35,225,190,35,35,Direct
3418160,200,15,35,150,115,35,35,Direct
3423572,150,0,50,325,275,50,50,Direct
3393474,100,0,35,240,205,35,35,Direct
3425430,75,0,35,225,190,35,35,Direct
3426966,125,0,40,200,160,40,40,Direct
3393414,250,50,50,240,190,50,50,Direct
3419750,300,70,50,340,290,50,50,Direct
3420852,50,0,35,260,225,35,35,Direct
3423453,200,0,35,175,140,35,35,Direct
3424789,250,40,35,175,140,35,35,Direct
3401443,425,115,280,695,415,280,280,Direct
3408204,150,0,35,120,85,35,35,Direct
3413450,275,45,50,320,270,50,50,Direct
3419091,125,0,20,140,120,20,20,Direct
3422644,125,0,35,260,225,35,35,Direct
3423912,75,0,35,225,190,35,35,Direct
3424014,300,0,35,145,110,35,35,Direct
3424805,200,0,35,240,205,35,35,Direct
3425014,200,0,35,145,110,35,35,Direct
3381741,75,0,50,375,325,50,50,Direct
3417325,50,0,20,175,155,20,20,Direct
3421269,100,0,35,260,225,35,35,Direct
3422606,400,95,35,220,185,35,35,Direct
3389064,100,0,35,220,185,35,35,Direct
3391840,25,0,35,125,90,35,35,Direct
3406516,150,0,35,120,85,35,35,Direct
3412423,125,0,35,225,190,35,35,Direct
3416276,75,0,35,225,190,35,35,Direct
3417246,250,45,35,225,190,35,35,Direct
3419641,125,0,60,120,60,60,60,Direct
3423126,125,0,35,260,225,35,35,Direct
3423128,50,0,35,200,165,35,35,Direct
3425334,225,0,35,260,225,35,35,Direct
3425298,100,0,35,225,190,35,35,Direct
3386253,125,0,35,240,205,35,35,Direct
3394680,250,45,35,155,120,35,35,Direct
3400696,150,0,35,170,135,35,35,Direct
3413278,225,30,35,235,200,35,35,Direct
3414264,275,75,35,265,230,35,35,Direct
3415671,125,0,36,171,135,36,36,Direct
3401595,100,0,35,125,90,35,35,Direct
3396073,75,0,35,225,190,35,35,Direct
3410177,175,0,35,180,145,35,35,Direct
3410513,175,0,35,100,65,35,35,Direct
3411283,225,20,35,175,140,35,35,Direct
3414357,125,0,35,180,145,35,35,Direct
3422932,50,0,35,260,225,35,35,Direct
3423666,125,0,35,260,225,35,35,Direct
3423851,475,170,50,250,200,50,50,Direct
3424451,25,0,35,275,240,35,35,Direct
3424602,75,0,35,230,195,35,35,Direct
3425789,300,0,50,350,300,50,50,Direct
3409248,150,0,16,46,30,16,16,Direct
3414478,200,15,20,80,60,20,20,Direct
3418086,225,35,35,190,155,35,35,Direct
3418215,275,55,35,265,230,35,35,Direct
3413492,25,0,35,225,190,35,35,Direct
3425381,250,0,50,265,215,50,50,Direct
3395219,125,0,35,150,115,35,35,Direct
3418690,100,0,35,165,130,35,35,Direct
3420555,125,0,35,220,185,35,35,Direct
3421155,125,0,35,260,225,35,35,Direct
3422984,100,0,35,175,140,35,35,Direct
3423970,50,0,25,90,65,25,25,Direct
3426285,125,0,35,260,225,35,35,Direct
3429679,525,220,50,365,315,50,50,Direct
3433480,225,15,25,75,50,25,25,Direct
3433980,125,0,25,80,55,25,25,Direct
3430172,50,0,35,245,210,35,35,Direct
3394574,200,10,35,195,160,35,35,Direct
3400347,100,0,20,140,120,20,20,Direct
3402126,400,130,35,105,70,35,35,Direct
3407449,100,0,35,155,120,35,35,Direct
3410082,125,0,35,140,105,35,35,Direct
3414001,50,0,35,140,105,35,35,Direct
3416273,250,60,35,175,140,35,35,Direct
3416741,200,10,35,240,205,35,35,Direct
3404047,200,10,20,75,55,20,20,Direct
3405936,50,0,20,75,55,20,20,Direct
3410344,150,0,20,195,175,20,20,Direct
3414607,125,0,50,260,210,50,50,Direct
3415458,225,35,35,120,85,35,35,Direct
3405030,275,55,35,150,115,35,35,Direct
3424018,200,0,35,260,225,35,35,Direct
3424954,275,115,110,405,295,110,110,Direct
3420923,100,0,35,255,220,35,35,Direct
3422548,75,0,35,230,195,35,35,Direct
3425722,225,15,35,225,190,35,35,Direct
3433040,100,0,35,150,115,35,35,Direct
3436835,125,0,35,145,110,35,35,Direct
3437218,75,0,36,106,70,36,36,Direct
3435014,2875,2280,350,2750,2400,350,350,Direct
3438890,225,20,50,220,170,50,50,Direct
3396072,150,0,35,250,215,35,35,Direct
3441766,175,0,35,140,105,35,35,Direct
3442000,175,0,20,80,60,20,20,Direct
3405615,175,0,35,260,225,35,35,Direct
3443604,225,0,35,250,215,35,35,Direct
3444421,175,0,60,170,110,60,60,Direct
3444842,100,0,35,250,215,35,35,Direct
3445493,400,95,20,175,155,20,20,Direct
3446195,125,0,20,60,40,20,20,Direct
3446276,75,0,60,195,135,60,60,Direct
3405356,75,0,35,125,90,35,35,Direct
3428555,150,0,80,280,200,80,80,Direct
3430559,225,0,35,250,215,35,35,Direct
3415852,375,90,50,225,175,50,50,Direct
3435171,175,0,35,260,225,35,35,Direct
3435321,150,0,45,125,80,45,45,Direct
3435707,300,85,20,190,170,20,20,Direct
3436040,150,0,50,275,225,50,50,Direct
3439519,225,15,35,180,145,35,35,Direct
3439783,100,0,20,170,150,20,20,Direct
3440452,125,0,35,250,215,35,35,Direct
3429909,225,15,35,250,215,35,35,Direct
3444145,250,40,35,250,215,35,35,Direct
3432981,125,0,20,80,60,20,20,Direct
3446522,550,230,40,295,255,40,40,Direct
3447272,75,0,20,80,60,20,20,Direct
3446293,75,0,35,155,120,35,35,Direct
3446327,300,0,35,190,155,35,35,Direct
3446795,100,0,50,270,220,50,50,Direct
3447199,175,0,75,300,225,75,75,Direct
3448633,275,65,60,130,70,60,60,Direct
3409895,200,0,35,250,215,35,35,Direct
3450807,150,0,35,250,215,35,35,Direct
3449318,75,0,20,125,105,20,20,Direct
3453364,275,0,25,50,25,25,25,Direct
3453479,150,0,50,340,290,50,50,Direct
3440830,75,0,25,90,65,25,25,Direct
3454917,50,0,40,250,210,40,40,Direct
3455555,100,0,25,75,50,25,25,Direct
3455670,125,0,35,150,115,35,35,Direct
3456053,125,0,35,155,120,35,35,Direct
3456223,125,0,35,240,205,35,35,Direct
3457159,2325,1655,650,2495,1845,650,650,Direct
3457206,100,0,35,115,80,35,35,Direct
3457423,150,0,35,155,120,35,35,Direct
3457610,175,0,35,250,215,35,35,Direct
3457827,250,0,35,135,100,35,35,Direct
3458112,50,0,25,50,25,25,25,Direct
3458346,275,0,50,265,215,50,50,Direct
3458546,275,65,100,235,135,100,100,Direct
3458593,375,135,50,385,335,50,50,Direct
3458695,175,0,50,265,215,50,50,Direct
3459746,225,15,25,50,25,25,25,Direct
3445093,400,95,49,219,170,49,49,Direct
3460299,275,0,20,50,30,20,20,Direct
3461001,450,170,50,275,225,50,50,Direct
3461052,175,0,35,150,115,35,35,Direct
3461503,75,0,20,60,40,20,20,Direct
3461720,150,0,50,250,200,50,50,Direct
3461771,100,0,50,250,200,50,50,Direct
3461852,75,0,20,85,65,20,20,Direct
3462741,150,0,50,225,175,50,50,Direct
3462758,375,115,85,230,145,85,85,Direct
3462771,450,170,35,225,190,35,35,Direct
3463005,350,95,50,205,155,50,50,Direct
3428541,125,0,35,225,190,35,35,Direct
3428809,300,15,35,270,235,35,35,Direct
3430131,75,0,35,180,145,35,35,Direct
3430256,100,0,35,225,190,35,35,Direct
3434200,25,0,35,245,210,35,35,Direct
3434732,125,0,35,265,230,35,35,Direct
3367146,100,0,35,150,115,35,35,Direct
3435404,150,0,35,130,95,35,35,Direct
3436654,100,0,35,170,135,35,35,Direct
3439355,200,0,35,250,215,35,35,Direct
3442231,400,90,35,245,210,35,35,Direct
3442495,275,70,75,330,255,75,75,Direct
3445571,325,40,60,145,85,60,60,Direct
3446818,300,0,35,110,75,35,35,Direct
3449583,400,120,75,300,225,75,75,Direct
3426906,100,0,40,325,285,40,40,Direct
3428444,75,0,35,195,160,35,35,Direct
3431188,225,15,50,315,265,50,50,Direct
3432171,125,0,60,195,135,60,60,Direct
3432188,125,0,35,260,225,35,35,Direct
3434445,350,185,35,250,215,35,35,Direct
3437687,150,0,35,265,230,35,35,Direct
3410832,300,0,51,211,160,51,51,Direct
3424921,275,0,35,250,215,35,35,Direct
3438525,125,0,25,80,55,25,25,Direct
3439225,75,0,35,135,100,35,35,Direct
3441933,275,0,35,150,115,35,35,Direct
3444956,125,0,50,325,275,50,50,Direct
3444656,300,0,35,250,215,35,35,Direct
3447447,225,0,35,250,215,35,35,Direct
3448400,200,0,20,170,150,20,20,Direct
3373409,100,0,25,70,45,25,25,Direct
3448719,150,0,25,50,25,25,25,Direct
3448900,125,0,35,245,210,35,35,Direct
3449070,150,0,60,140,80,60,60,Direct
3446511,225,0,35,140,105,35,35,Direct
3450055,150,0,60,155,95,60,60,Direct
3421454,400,95,35,200,165,35,35,Direct
3430514,175,0,50,250,200,50,50,Direct
3431150,125,0,35,260,225,35,35,Direct
3432952,100,0,25,75,50,25,25,Direct
3429978,200,0,35,260,225,35,35,Direct
3435160,125,0,50,325,275,50,50,Direct
3435194,75,0,50,325,275,50,50,Direct
3435460,175,0,35,260,225,35,35,Direct
3435787,100,0,25,55,30,25,25,Direct
3436253,175,0,35,190,155,35,35,Direct
3437832,225,15,35,170,135,35,35,Direct
3440033,275,0,35,250,215,35,35,Direct
3440331,375,65,20,105,85,20,20,Direct
3442246,125,0,25,55,30,25,25,Direct
3445177,250,40,50,250,200,50,50,Direct
3446090,225,0,35,185,150,35,35,Direct
3446592,175,0,50,205,155,50,50,Direct
3446685,200,0,35,250,215,35,35,Direct
3446883,125,0,50,250,200,50,50,Direct
3433822,200,0,25,55,30,25,25,Direct
3448721,300,20,25,60,35,25,25,Direct
3427851,50,0,35,250,215,35,35,Direct
3428770,75,0,50,225,175,50,50,Direct
3429592,225,0,50,325,275,50,50,Direct
3434471,250,0,20,175,155,20,20,Direct
3435957,100,0,20,175,155,20,20,Direct
3436025,425,120,110,455,345,110,110,Direct
3436893,225,0,35,260,225,35,35,Direct
3437611,100,0,40,210,170,40,40,Direct
3439216,275,0,35,105,70,35,35,Direct
3441105,225,15,50,220,170,50,50,Direct
3442627,75,0,20,175,155,20,20,Direct
3443095,125,0,35,160,125,35,35,Direct
3445700,300,90,75,315,240,75,75,Direct
3445818,100,0,20,105,85,20,20,Direct
3446185,250,0,60,195,135,60,60,Direct
3446572,325,20,20,160,140,20,20,Direct
3446989,150,0,50,225,175,50,50,Direct
3447022,100,0,35,195,160,35,35,Direct
3450065,250,0,60,195,135,60,60,Direct
3450533,125,0,35,125,90,35,35,Direct
3446171,250,0,35,135,100,35,35,Direct
3453188,100,0,25,85,60,25,25,Direct
3453992,50,0,20,30,10,20,20,Direct
3411346,125,0,35,160,125,35,35,Direct
3427615,100,0,35,240,205,35,35,Direct
3428726,225,0,36,106,70,36,36,Direct
3421638,125,0,5,10,5,5,5,Direct
3430287,325,40,35,250,215,35,35,Direct
3416217,100,0,50,230,180,50,50,Direct
3433236,25,0,25,80,55,25,25,Direct
3434299,325,110,35,235,200,35,35,Direct
3435342,100,0,35,115,80,35,35,Direct
3436707,275,0,35,225,190,35,35,Direct
3437141,225,0,35,260,225,35,35,Direct
3420536,50,0,35,245,210,35,35,Direct
3438184,125,0,25,70,45,25,25,Direct
3438277,125,0,35,275,240,35,35,Direct
3441651,300,0,35,275,240,35,35,Direct
3441928,125,0,35,125,90,35,35,Direct
3442030,350,70,75,380,305,75,75,Direct
3442898,200,0,50,235,185,50,50,Direct
3443230,100,0,20,175,155,20,20,Direct
3444000,175,0,20,75,55,20,20,Direct
3444234,125,0,50,225,175,50,50,Direct
3444425,350,135,35,240,205,35,35,Direct
3445336,200,0,35,140,105,35,35,Direct
3423473,125,0,35,220,185,35,35,Direct
3413564,375,70,35,250,215,35,35,Direct
3426917,175,0,20,60,40,20,20,Direct
3427904,100,0,35,250,215,35,35,Direct
3426082,100,0,10,15,5,10,10,Direct
3430426,200,0,20,190,170,20,20,Direct
3431462,475,160,35,260,225,35,35,Direct
3432448,150,0,25,75,50,25,25,Direct
3433483,100,0,35,225,190,35,35,Direct
3434170,375,70,60,190,130,60,60,Direct
3436942,200,0,50,315,265,50,50,Direct
3438699,425,145,35,250,215,35,35,Direct
3440235,125,0,20,35,15,20,20,Direct
3441722,250,0,35,250,215,35,35,Direct
3443043,350,40,35,240,205,35,35,Direct
3444130,275,0,35,250,215,35,35,Direct
3444716,150,0,35,250,215,35,35,Direct
3445115,75,0,35,200,165,35,35,Direct
3445802,100,0,35,250,215,35,35,Direct
3446702,75,0,25,50,25,25,25,Direct
3446873,225,15,45,195,150,45,45,Direct
3427661,400,95,35,250,215,35,35,Direct
3427676,75,0,35,250,215,35,35,Direct
3430633,125,0,25,80,55,25,25,Direct
3432475,100,0,50,250,200,50,50,Direct
3435583,425,120,35,260,225,35,35,Direct
3436785,350,180,35,250,215,35,35,Direct
3437121,175,0,35,250,215,35,35,Direct
3437636,275,0,35,260,225,35,35,Direct
3438455,250,0,50,150,100,50,50,Direct
3438806,175,0,20,95,75,20,20,Direct
3440293,425,115,35,250,215,35,35,Direct
3440478,175,0,20,25,5,20,20,Direct
3443535,75,0,35,150,115,35,35,Direct
3446096,100,0,20,175,155,20,20,Direct
3446630,250,40,50,225,175,50,50,Direct
3447379,100,0,35,250,215,35,35,Direct
3439442,175,0,50,220,170,50,50,Direct
3448451,100,0,35,250,215,35,35,Direct
3450742,175,0,20,175,155,20,20,Direct
3451842,225,15,25,95,70,25,25,Direct
3452363,25,0,15,60,45,15,15,Direct
3452529,125,0,35,240,205,35,35,Direct
3453816,375,90,60,190,130,60,60,Direct
3454201,275,65,75,375,300,75,75,Direct
3454450,75,0,35,105,70,35,35,Direct
3455237,125,0,20,135,115,20,20,Direct
3455435,175,0,50,250,200,50,50,Direct
3455486,75,0,35,150,115,35,35,Direct
3456188,150,0,35,190,155,35,35,Direct
3456558,125,0,35,170,135,35,35,Direct
3456673,125,0,35,250,215,35,35,Direct
3456907,150,0,35,245,210,35,35,Direct
3457009,100,0,35,165,130,35,35,Direct
3457107,175,0,35,250,215,35,35,Direct
3458160,500,220,110,425,315,110,110,Direct
3449772,175,0,35,160,125,35,35,Direct
3459030,300,20,50,200,150,50,50,Direct
3459581,175,0,35,255,220,35,35,Direct
3459766,125,0,35,225,190,35,35,Direct
3460868,150,0,20,80,60,20,20,Direct
3461204,175,0,50,250,200,50,50,Direct
3461217,75,0,10,15,5,10,10,Direct
3461504,400,90,50,250,200,50,50,Direct
3447947,425,145,50,200,150,50,50,Direct
3458445,100,0,15,70,55,15,15,Direct
3462289,200,0,50,210,160,50,50,Direct
3458845,175,0,50,210,160,50,50,Direct
3462604,75,0,35,150,115,35,35,Direct
3463140,100,0,35,140,105,35,35,Direct
3463174,200,0,35,225,190,35,35,Direct
3463476,175,0,35,185,150,35,35,Direct
3463576,75,0,35,205,170,35,35,Direct
3463810,75,0,35,160,125,35,35,Direct
3463874,100,0,50,210,160,50,50,Direct
3464697,125,0,35,155,120,35,35,Direct
3464846,125,0,20,170,150,20,20,Direct
3445875,125,0,35,265,230,35,35,Direct
3465212,100,0,50,215,165,50,50,Direct
3447538,200,0,50,325,275,50,50,Direct
3448124,100,0,50,220,170,50,50,Direct
3448123,250,0,50,205,155,50,50,Direct
3419129,1025,515,200,1100,900,200,200,Direct
3445451,150,0,25,85,60,25,25,Direct
3426096,125,0,35,150,115,35,35,Direct
3450296,325,20,40,210,170,40,40,Direct
3450967,125,0,60,165,105,60,60,Direct
3451032,150,5,50,220,170,50,50,Direct
3451382,100,0,50,255,205,50,50,Direct
3452204,250,0,25,75,50,25,25,Direct
3445315,125,0,25,65,40,25,25,Direct
3443480,150,0,35,190,155,35,35,Direct
3455762,125,0,60,130,70,60,60,Direct
3456733,100,0,60,105,45,60,60,Direct
3456984,200,0,60,110,50,60,60,Direct
3456748,150,0,25,75,50,25,25,Direct
3457233,125,0,35,190,155,35,35,Direct
3457248,100,0,20,75,55,20,20,Direct
3457483,300,90,35,245,210,35,35,Direct
3457534,125,0,35,150,115,35,35,Direct
3458819,125,0,35,115,80,35,35,Direct
3458805,325,45,50,275,225,50,50,Direct
3459541,150,0,35,105,70,35,35,Direct
3460642,175,0,50,200,150,50,50,Direct
3461242,200,0,25,90,65,25,25,Direct
3461327,200,0,50,205,155,50,50,Direct
3461627,325,20,25,75,50,25,25,Direct
3459356,175,0,35,140,105,35,35,Direct
3448766,675,85,50,325,275,50,50,Direct
3448951,100,0,5,10,5,5,5,Direct
3448987,125,0,5,10,5,5,5,Direct
3440814,125,0,35,195,160,35,35,Direct
3433526,400,90,150,350,200,150,150,Direct
3450340,175,0,60,115,55,60,60,Direct
3426825,125,0,20,175,155,20,20,Direct
3424851,150,0,20,80,60,20,20,Direct
3451025,225,0,50,230,180,50,50,Direct
3451440,150,0,60,150,90,60,60,Direct
3451561,100,0,20,145,125,20,20,Direct
3451759,175,0,35,250,215,35,35,Direct
3451925,100,0,35,270,235,35,35,Direct
3451959,175,0,25,75,50,25,25,Direct
3451995,75,0,35,110,75,35,35,Direct
3452276,200,0,25,55,30,25,25,Direct
3452446,100,0,10,15,5,10,10,Direct
3452661,1575,995,500,1500,1000,500,500,Direct
3453248,75,0,50,205,155,50,50,Direct
3453731,350,65,25,95,70,25,25,Direct
3454131,25,0,35,190,155,35,35,Direct
3454582,100,0,35,175,140,35,35,Direct
3454967,325,45,20,155,135,20,20,Direct
3455603,100,0,35,190,155,35,35,Direct
3455705,300,15,35,205,170,35,35,Direct
3455769,75,0,35,120,85,35,35,Direct
3456103,225,15,35,135,100,35,35,Direct
3456354,125,0,35,145,110,35,35,Direct
3456656,100,0,20,25,5,20,20,Direct
3457041,175,0,50,205,155,50,50,Direct
3457090,100,0,35,265,230,35,35,Direct
3457692,100,0,35,190,155,35,35,Direct
3458011,125,0,35,250,215,35,35,Direct
3458077,100,0,60,150,90,60,60,Direct
3458075,75,0,35,110,75,35,35,Direct
3458111,125,0,35,180,145,35,35,Direct
3454869,475,165,50,245,195,50,50,Direct
3458477,725,405,155,700,545,155,155,Direct
3459128,325,15,35,150,115,35,35,Direct
3459213,175,0,50,215,165,50,50,Direct
3459813,375,120,80,430,350,80,80,Direct
3429148,250,100,35,150,115,35,35,Direct
3460385,125,0,50,200,150,50,50,Direct
3460634,75,0,35,190,155,35,35,Direct
3427339,100,0,35,225,190,35,35,Direct
3427739,300,15,35,260,225,35,35,Direct
3429168,150,0,35,260,225,35,35,Direct
3435170,125,0,10,20,10,10,10,Direct
3436370,100,0,25,80,55,25,25,Direct
3436949,125,0,35,225,190,35,35,Direct
3436999,100,0,60,195,135,60,60,Direct
3437735,250,40,50,225,175,50,50,Direct
3421373,225,0,35,155,120,35,35,Direct
3438078,425,145,80,430,350,80,80,Direct
3438485,75,0,50,275,225,50,50,Direct
3375729,225,0,50,325,275,50,50,Direct
3439314,150,0,20,190,170,20,20,Direct
3396144,100,0,35,225,190,35,35,Direct
3440443,175,0,50,285,235,50,50,Direct
3440900,125,0,25,90,65,25,25,Direct
3442765,375,95,50,295,245,50,50,Direct
3443022,375,90,35,150,115,35,35,Direct
3443415,150,0,35,225,190,35,35,Direct
3443715,50,0,50,275,225,50,50,Direct
3446323,275,0,20,140,120,20,20,Direct
3446566,125,0,35,160,125,35,35,Direct
3447495,200,0,35,225,190,35,35,Direct
3447695,75,0,35,140,105,35,35,Direct
3447802,225,0,35,115,80,35,35,Direct
3448545,150,0,35,245,210,35,35,Direct
3432075,100,0,35,195,160,35,35,Direct
3432211,125,0,60,130,70,60,60,Direct
3432411,175,0,35,260,225,35,35,Direct
3434283,200,0,35,225,190,35,35,Direct
3435128,275,0,60,160,100,60,60,Direct
3436955,275,70,20,95,75,20,20,Direct
3434392,125,0,20,125,105,20,20,Direct
3439229,500,180,35,250,215,35,35,Direct
3438570,100,0,35,260,225,35,35,Direct
3441078,75,0,20,80,60,20,20,Direct
3442035,350,45,60,135,75,60,60,Direct
3442271,75,0,60,130,70,60,60,Direct
3443509,100,0,35,245,210,35,35,Direct
3440801,175,0,35,185,150,35,35,Direct
3446381,150,0,60,185,125,60,60,Direct
3447453,100,0,35,280,245,35,35,Direct
3447560,175,0,50,270,220,50,50,Direct
3427660,500,190,50,325,275,50,50,Direct
3427911,475,190,75,300,225,75,75,Direct
3428247,125,0,35,255,220,35,35,Direct
3429298,150,0,35,250,215,35,35,Direct
3429549,100,0,20,140,120,20,20,Direct
3429583,125,0,35,250,215,35,35,Direct
3429681,400,90,35,250,215,35,35,Direct
3431119,100,0,35,245,210,35,35,Direct
3431238,100,0,25,85,60,25,25,Direct
3431906,75,0,35,115,80,35,35,Direct
3431940,125,0,35,100,65,35,35,Direct
3432106,200,0,50,325,275,50,50,Direct
3436369,225,0,50,295,245,50,50,Direct
3438556,550,235,75,385,310,75,75,Direct
3438756,175,0,35,265,230,35,35,Direct
3438841,175,0,35,240,205,35,35,Direct
3439458,425,115,35,225,190,35,35,Direct
3440313,250,0,35,250,215,35,35,Direct
3432706,275,0,20,130,110,20,20,Direct
3442283,225,0,35,110,75,35,35,Direct
3442334,200,0,20,60,40,20,20,Direct
3432489,375,65,50,225,175,50,50,Direct
3444606,100,0,35,150,115,35,35,Direct
3445742,75,0,20,90,70,20,20,Direct
3446844,225,15,45,195,150,45,45,Direct
3446780,100,0,25,95,70,25,25,Direct
3446895,125,0,20,180,160,20,20,Direct
3446814,175,0,20,175,155,20,20,Direct
3447414,225,0,35,100,65,35,35,Direct
3422542,225,0,35,250,215,35,35,Direct
3427588,350,65,20,175,155,20,20,Direct
3427749,125,0,35,190,155,35,35,Direct
3429119,200,0,50,320,270,50,50,Direct
3421095,225,15,35,105,70,35,35,Direct
3439713,100,0,35,245,210,35,35,Direct
3430566,100,0,35,150,115,35,35,Direct
3441794,125,0,35,125,90,35,35,Direct
3441960,275,0,20,150,130,20,20,Direct
3443091,200,0,35,105,70,35,35,Direct
3443832,225,15,35,260,225,35,35,Direct
3444870,200,0,35,180,145,35,35,Direct
3446533,425,0,50,340,290,50,50,Direct
3446767,225,0,20,80,60,20,20,Direct
3447074,75,0,20,45,25,20,20,Direct
3447133,500,215,50,325,275,50,50,Direct
3447303,275,0,60,190,130,60,60,Direct
3447937,150,0,50,260,210,50,50,Direct
3448010,350,185,50,255,205,50,50,Direct
3449341,125,0,35,145,110,35,35,Direct
3449877,50,0,35,165,130,35,35,Direct
3449941,150,0,35,135,100,35,35,Direct
3461200,125,0,50,250,200,50,50,Direct
3461672,100,0,35,170,135,35,35,Direct
3461736,425,145,50,325,275,50,50,Direct
3461785,100,0,35,160,125,35,35,Direct
3462721,150,0,50,225,175,50,50,Direct
3462772,125,0,35,170,135,35,35,Direct
3462808,125,0,20,90,70,20,20,Direct
3463157,125,0,50,220,170,50,50,Direct
3463242,125,0,20,35,15,20,20,Direct
3463342,375,0,50,235,185,50,50,Direct
3463608,400,120,20,170,150,20,20,Direct
3463708,100,0,35,140,105,35,35,Direct
3463457,100,0,20,65,45,20,20,Direct
3463944,100,0,75,300,225,75,75,Direct
3464178,75,0,60,125,65,60,60,Direct
3464563,175,0,35,125,90,35,35,Direct
3464627,100,0,35,190,155,35,35,Direct
3464878,200,0,60,190,130,60,60,Direct
3465129,300,90,40,340,300,40,40,Direct
3465563,175,0,15,80,65,15,15,Direct
3465765,75,0,20,140,120,20,20,Direct
3380329,325,20,75,370,295,75,75,Direct
3466435,100,0,35,195,160,35,35,Direct
3448415,175,0,35,125,90,35,35,Direct
3466701,300,0,20,145,125,20,20,Direct
3466735,300,15,35,190,155,35,35,Direct
3466852,200,0,60,100,40,60,60,Direct
3466952,150,0,35,150,115,35,35,Direct
3467001,150,0,35,100,65,35,35,Direct
3466499,275,0,35,185,150,35,35,Direct
3467886,75,0,20,80,60,20,20,Direct
3467952,175,0,35,140,105,35,35,Direct
3468071,250,0,20,160,140,20,20,Direct
3468137,175,0,50,235,185,50,50,Direct
3468624,100,0,35,150,115,35,35,Direct
3468537,250,0,35,170,135,35,35,Direct
3468722,350,65,25,95,70,25,25,Direct
3468771,125,0,20,140,120,20,20,Direct
3469173,125,0,20,160,140,20,20,Direct
3469407,50,0,50,200,150,50,50,Direct
3469758,150,0,25,80,55,25,25,Direct
3470879,175,25,50,250,200,50,50,Direct
3464027,150,0,36,156,120,36,36,Direct
3471445,100,0,35,190,155,35,35,Direct
3466786,300,90,35,190,155,35,35,Direct
3411247,100,0,50,270,220,50,50,Direct
3462564,375,65,35,240,205,35,35,Direct
3455411,225,15,35,145,110,35,35,Direct
3462713,50,0,35,225,190,35,35,Direct
3462850,125,0,35,150,115,35,35,Direct
3462849,125,0,20,140,120,20,20,Direct
3463300,150,0,35,190,155,35,35,Direct
3463499,275,65,40,230,190,40,40,Direct
3426818,125,0,35,100,65,35,35,Direct
3463585,100,0,35,170,135,35,35,Direct
3463936,125,0,50,235,185,50,50,Direct
3463986,150,0,35,265,230,35,35,Direct
3464136,100,0,35,160,125,35,35,Direct
3464135,225,15,20,75,55,20,20,Direct
3464186,100,0,35,100,65,35,35,Direct
3464200,150,0,50,325,275,50,50,Direct
3464471,200,0,50,240,190,50,50,Direct
3464871,225,0,35,180,145,35,35,Direct
3464886,75,0,50,220,170,50,50,Direct
3465172,175,0,35,170,135,35,35,Direct
3461128,375,65,50,250,200,50,50,Direct
3466493,200,0,35,150,115,35,35,Direct
3466207,125,0,35,140,105,35,35,Direct
3465721,50,0,20,180,160,20,20,Direct
3464150,150,0,35,245,210,35,35,Direct
3461663,250,40,50,255,205,50,50,Direct
3442158,150,0,20,145,125,20,20,Direct
3466707,75,0,50,230,180,50,50,Direct
3466793,350,135,150,385,235,150,150,Direct
3466808,175,0,35,180,145,35,35,Direct
3462128,200,0,50,255,205,50,50,Direct
3467144,150,0,50,255,205,50,50,Direct
3467344,300,0,50,200,150,50,50,Direct
3467394,150,0,35,215,180,35,35,Direct
3467479,100,0,50,205,155,50,50,Direct
3467730,300,15,50,235,185,50,50,Direct
3467729,150,0,35,285,250,35,35,Direct
3467794,100,0,50,250,200,50,50,Direct
3468094,200,0,35,125,90,35,35,Direct
3468130,75,0,25,90,65,25,25,Direct
3468379,100,0,35,140,105,35,35,Direct
3468430,300,20,35,170,135,35,35,Direct
3468465,375,70,58,143,85,58,58,Direct
3468830,200,0,50,275,225,50,50,Direct
3468915,125,0,35,150,115,35,35,Direct
3469316,125,0,20,105,85,20,20,Direct
3434666,400,90,35,225,190,35,35,Direct
3437710,625,285,310,770,460,310,310,Direct
3437717,150,0,35,260,225,35,35,Direct
3392468,50,0,35,160,125,35,35,Direct
3439139,275,0,50,240,190,50,50,Direct
3439796,100,0,35,245,210,35,35,Direct
3440039,75,0,35,225,190,35,35,Direct
3438496,350,45,110,405,295,110,110,Direct
3440468,125,0,35,240,205,35,35,Direct
3440768,125,0,25,50,25,25,25,Direct
3442654,25,0,20,175,155,20,20,Direct
3442933,175,0,50,225,175,50,50,Direct
3446155,150,0,35,250,215,35,35,Direct
3447284,350,45,20,135,115,20,20,Direct
3447420,200,0,35,115,80,35,35,Direct
3447827,100,0,35,275,240,35,35,Direct
3449392,125,0,50,275,225,50,50,Direct
3446498,275,0,100,200,100,100,100,Direct
3451721,125,0,20,105,85,20,20,Direct
3452314,250,40,35,250,215,35,35,Direct
3455358,175,0,20,35,15,20,20,Direct
3455601,300,20,25,65,40,25,25,Direct
3456951,200,0,50,270,220,50,50,Direct
3458223,100,0,20,80,60,20,20,Direct
3449564,275,0,35,110,75,35,35,Direct
3451472,325,40,20,95,75,20,20,Direct
3441169,75,0,33,118,85,33,33,Direct
3451770,350,45,35,250,215,35,35,Direct
3451963,200,0,35,155,120,35,35,Direct
3452165,75,0,25,65,40,25,25,Direct
3452501,75,0,20,150,130,20,20,Direct
3453108,125,0,35,150,115,35,35,Direct
3453835,100,0,20,80,60,20,20,Direct
3454337,250,40,25,85,60,25,25,Direct
3454078,225,15,25,50,25,25,25,Direct
3450936,150,0,20,135,115,20,20,Direct
3455407,150,0,20,135,115,20,20,Direct
3455614,100,0,19,44,25,19,19,Direct
3455950,250,40,60,125,65,60,60,Direct
3456809,375,95,60,165,105,60,60,Direct
3456852,225,0,50,215,165,50,50,Direct
3457052,175,0,35,115,80,35,35,Direct
3457145,125,0,35,250,215,35,35,Direct
3457479,825,465,450,1250,800,450,450,Direct
3457688,150,0,50,285,235,50,50,Direct
3457879,250,0,25,75,50,25,25,Direct
3454737,150,0,20,135,115,20,20,Direct
3458124,225,0,60,135,75,60,60,Direct
3458324,125,0,18,43,25,18,18,Direct
3452965,425,145,35,250,215,35,35,Direct
3440969,175,0,50,200,150,50,50,Direct
3457679,150,0,35,130,95,35,35,Direct
3459851,100,0,20,95,75,20,20,Direct
3460732,175,0,35,250,215,35,35,Direct
3461430,150,0,20,80,60,20,20,Direct
3461525,50,0,35,190,155,35,35,Direct
3422786,125,0,35,220,185,35,35,Direct
3425794,225,0,60,105,45,60,60,Direct
3429820,125,0,25,65,40,25,25,Direct
3431024,125,0,35,150,115,35,35,Direct
3433053,175,0,50,270,220,50,50,Direct
3434700,125,0,35,260,225,35,35,Direct
3435418,150,0,35,260,225,35,35,Direct
3435768,175,0,35,150,115,35,35,Direct
3436304,200,0,60,130,70,60,60,Direct
3436329,200,0,50,225,175,50,50,Direct
3436972,250,0,35,225,190,35,35,Direct
3437265,300,15,50,235,185,50,50,Direct
3404952,200,0,20,75,55,20,20,Direct
3440166,425,120,50,290,240,50,50,Direct
3440877,225,0,25,50,25,25,25,Direct
3441677,225,15,60,195,135,60,60,Direct
3424297,175,0,35,195,160,35,35,Direct
3445489,75,0,35,250,215,35,35,Direct
3448082,50,0,25,50,25,25,25,Direct
3449086,50,0,20,130,110,20,20,Direct
3429464,450,145,35,245,210,35,35,Direct
3449686,200,0,25,85,60,25,25,Direct
3450941,200,0,20,75,55,20,20,Direct
3450992,175,0,50,275,225,50,50,Direct
3451039,100,0,23,78,55,23,23,Direct
3451243,125,0,20,145,125,20,20,Direct
3451877,125,0,60,195,135,60,60,Direct
3451975,175,0,35,250,215,35,35,Direct
3452430,125,0,35,225,190,35,35,Direct
3453864,275,0,20,95,75,20,20,Direct
3454685,350,90,100,230,130,100,100,Direct
3457008,125,0,50,325,275,50,50,Direct
3457106,125,0,35,190,155,35,35,Direct
3457306,25,0,50,240,190,50,50,Direct
3457425,150,0,25,60,35,25,25,Direct
3439190,75,0,35,175,140,35,35,Direct
3448235,175,0,35,200,165,35,35,Direct
3458646,225,15,50,245,195,50,50,Direct
3397793,150,0,50,200,150,50,50,Direct
3458812,75,0,20,85,65,20,20,Direct
3458897,350,45,35,190,155,35,35,Direct
3459429,150,0,50,200,150,50,50,Direct
3459748,225,15,35,195,160,35,35,Direct
3460067,325,115,50,305,255,50,50,Direct
3460267,175,0,35,195,160,35,35,Direct
3460803,125,0,25,95,70,25,25,Direct
3460799,300,0,35,190,155,35,35,Direct
3461220,150,0,35,280,245,35,35,Direct
3461386,100,0,20,90,70,20,20,Direct
3461518,400,90,50,250,200,50,50,Direct
3462088,100,0,35,225,190,35,35,Direct
3451655,100,0,35,105,70,35,35,Direct
3451787,200,0,35,135,100,35,35,Direct
3452230,100,0,35,110,75,35,35,Direct
3452591,125,0,20,80,60,20,20,Direct
3453252,325,45,25,80,55,25,25,Direct
3453320,100,0,35,175,140,35,35,Direct
3453520,75,0,35,190,155,35,35,Direct
3453634,325,15,35,125,90,35,35,Direct
3454663,225,0,25,75,50,25,25,Direct
3455667,225,0,20,100,80,20,20,Direct
3455724,225,0,35,180,145,35,35,Direct
3455731,150,0,33,163,130,33,33,Direct
3455999,200,0,105,355,250,105,105,Direct
3457553,75,0,35,150,115,35,35,Direct
3457646,175,0,35,250,215,35,35,Direct
3457728,50,0,20,80,60,20,20,Direct
3458650,400,90,50,275,225,50,50,Direct
3458825,375,95,50,245,195,50,50,Direct
3459050,50,0,20,130,110,20,20,Direct
3431549,300,20,50,275,225,50,50,Direct
3459268,200,0,35,190,155,35,35,Direct
3459679,100,0,35,190,155,35,35,Direct
3459736,200,0,35,225,190,35,35,Direct
3459804,150,0,50,240,190,50,50,Direct
3460204,475,190,75,300,225,75,75,Direct
3460211,400,0,20,80,60,20,20,Direct
3460522,125,0,20,160,140,20,20,Direct
3457528,100,0,35,180,145,35,35,Direct
3461858,250,0,35,275,240,35,35,Direct
3462126,125,0,35,170,135,35,35,Direct
3462483,75,0,50,250,200,50,50,Direct
3462619,275,0,35,150,115,35,35,Direct
3462951,175,0,60,195,135,60,60,Direct
3462994,350,120,35,260,225,35,35,Direct
3463087,100,0,35,130,95,35,35,Direct
3463462,125,0,35,175,140,35,35,Direct
3463748,200,0,35,125,90,35,35,Direct
3464548,100,0,50,250,200,50,50,Direct
3447608,225,15,50,270,220,50,50,Direct
3450348,50,0,35,185,150,35,35,Direct
3450497,100,0,35,250,215,35,35,Direct
3450748,150,0,50,245,195,50,50,Direct
3450947,200,0,35,160,125,35,35,Direct
3452338,600,290,75,460,385,75,75,Direct
3452505,400,210,50,325,275,50,50,Direct
3452806,125,0,25,70,45,25,25,Direct
3453573,300,0,25,90,65,25,25,Direct
3454559,350,45,25,90,65,25,25,Direct
3454742,2075,1320,800,3695,2895,800,800,Direct
3455142,175,0,35,235,200,35,35,Direct
3455495,400,115,50,250,200,50,50,Direct
3455828,175,0,25,70,45,25,25,Direct
3456513,225,15,35,190,155,35,35,Direct
3456614,75,0,50,200,150,50,50,Direct
3456831,100,0,35,190,155,35,35,Direct
3456981,225,15,25,75,50,25,25,Direct
3457385,375,70,33,173,140,33,33,Direct
3457636,250,105,50,200,150,50,50,Direct
3458018,75,0,35,150,115,35,35,Direct
3458218,125,0,10,15,5,10,10,Direct
3458636,275,65,35,170,135,35,35,Direct
3458772,75,0,50,325,275,50,50,Direct
3459504,175,0,35,135,100,35,35,Direct
3459240,75,0,35,195,160,35,35,Direct
3460243,50,0,35,190,155,35,35,Direct
3460358,250,0,50,235,185,50,50,Direct
3460508,225,0,35,125,90,35,35,Direct
3440737,175,0,35,190,155,35,35,Direct
3458103,150,0,35,175,140,35,35,Direct
3462397,225,0,35,115,80,35,35,Direct
3462529,200,0,35,165,130,35,35,Direct
3462848,125,0,35,160,125,35,35,Direct
3463098,225,15,20,95,75,20,20,Direct
3463251,75,0,25,75,50,25,25,Direct
3463451,100,0,35,170,135,35,35,Direct
3463516,175,0,20,150,130,20,20,Direct
3463515,200,0,20,160,140,20,20,Direct
3461932,200,0,50,220,170,50,50,Direct
3462002,100,0,20,140,120,20,20,Direct
3442012,125,0,23,73,50,23,23,Direct
3462568,150,0,50,325,275,50,50,Direct
3462759,150,0,60,195,135,60,60,Direct
3462861,125,0,35,170,135,35,35,Direct
3462959,100,0,35,125,90,35,35,Direct
3463695,150,0,23,78,55,23,23,Direct
3464038,150,0,35,240,205,35,35,Direct
3464138,225,15,60,160,100,60,60,Direct
3394405,175,0,35,165,130,35,35,Direct
3464674,125,0,20,150,130,20,20,Direct
3455507,225,15,20,145,125,20,20,Direct
3450327,175,0,25,60,35,25,25,Direct
3454178,150,0,35,180,145,35,35,Direct
3464940,175,0,25,50,25,25,25,Direct
3465110,150,0,35,190,155,35,35,Direct
3465169,125,0,50,245,195,50,50,Direct
3465276,275,0,50,255,205,50,50,Direct
3465369,150,0,35,265,230,35,35,Direct
3465610,250,0,35,130,95,35,35,Direct
3465676,100,0,50,215,165,50,50,Direct
3465846,125,0,35,150,115,35,35,Direct
3465946,75,0,50,230,180,50,50,Direct
3466212,200,0,35,125,90,35,35,Direct
3466439,50,0,35,110,75,35,35,Direct
3458188,200,0,35,195,160,35,35,Direct
3445454,75,0,35,125,90,35,35,Direct
3447685,400,90,50,270,220,50,50,Direct
3467048,300,15,35,190,155,35,35,Direct
3467246,125,0,35,175,140,35,35,Direct
3467584,100,0,50,210,160,50,50,Direct
3467675,75,0,35,240,205,35,35,Direct
3468284,75,0,25,60,35,25,25,Direct
3468511,525,220,110,490,380,110,110,Direct
3468611,300,145,50,300,250,50,50,Direct
3468920,350,135,110,400,290,110,110,Direct
3468911,375,65,35,125,90,35,35,Direct
3469154,50,0,50,255,205,50,50,Direct
3469177,250,0,50,325,275,50,50,Direct
3469347,125,0,35,195,160,35,35,Direct
3469647,250,0,35,155,120,35,35,Direct
3462466,75,0,35,190,155,35,35,Direct
3470054,250,0,20,140,120,20,20,Direct
3470056,75,0,20,50,30,20,20,Direct
3462373,100,0,35,250,215,35,35,Direct
3462790,250,0,35,250,215,35,35,Direct
3462824,250,0,50,255,205,50,50,Direct
3462858,225,0,35,155,120,35,35,Direct
3463258,175,0,60,165,105,60,60,Direct
3463607,200,0,35,275,240,35,35,Direct
3464028,75,0,35,225,190,35,35,Direct
3464228,300,20,50,285,235,50,50,Direct
3464262,225,15,35,215,180,35,35,Direct
3462556,125,0,50,215,165,50,50,Direct
3464845,150,0,25,70,45,25,25,Direct
3465062,75,0,50,250,200,50,50,Direct
3465113,150,0,35,245,210,35,35,Direct
3465479,125,0,35,190,155,35,35,Direct
3465764,75,0,20,75,55,20,20,Direct
3465832,100,0,20,160,140,20,20,Direct
3466100,100,0,35,150,115,35,35,Direct
3462454,175,0,50,240,190,50,50,Direct
3461722,350,95,35,270,235,35,35,Direct
3445491,225,0,20,100,80,20,20,Direct
3442301,125,0,50,275,225,50,50,Direct
3419623,275,115,35,175,140,35,35,Direct
3467287,175,0,35,190,155,35,35,Direct
3467453,325,15,20,45,25,20,20,Direct
3467568,400,95,35,180,145,35,35,Direct
3467653,150,0,35,150,115,35,35,Direct
3467670,300,0,35,185,150,35,35,Direct
3467687,175,0,35,145,110,35,35,Direct
3467802,200,0,35,165,130,35,35,Direct
3467853,125,0,10,15,5,10,10,Direct
3468070,175,0,50,230,180,50,50,Direct
3468287,75,0,35,145,110,35,35,Direct
3468372,100,0,50,275,225,50,50,Direct
3468406,350,70,50,260,210,50,50,Direct
3468504,175,0,20,95,75,20,20,Direct
3467521,125,0,35,120,85,35,35,Direct
3468674,100,0,35,190,155,35,35,Direct
3468423,325,20,35,190,155,35,35,Direct
3468823,375,90,50,275,225,50,50,Direct
3425303,100,0,50,200,150,50,50,Direct
3469108,250,0,59,119,60,59,59,Direct
3469223,350,45,75,300,225,75,75,Direct
3469342,175,0,50,200,150,50,50,Direct
3469376,150,0,75,300,225,75,75,Direct
3469393,575,305,110,445,335,110,110,Direct
3469759,150,0,50,235,185,50,50,Direct
3470810,100,0,20,55,35,20,20,Direct
3456221,125,0,35,100,65,35,35,Direct
3470895,125,0,35,105,70,35,35,Direct
3471112,125,0,20,180,160,20,20,Direct
3471214,175,0,35,180,145,35,35,Direct
3456644,100,0,35,120,85,35,35,Direct
3458959,150,0,50,275,225,50,50,Direct
3459302,275,15,110,400,290,110,110,Direct
3459495,200,0,35,240,205,35,35,Direct
3459545,100,0,25,50,25,25,25,Direct
3459509,125,0,60,150,90,60,60,Direct
3459809,175,0,35,135,100,35,35,Direct
3460145,175,0,35,125,90,35,35,Direct
3461124,150,0,60,135,75,60,60,Direct
3461767,200,0,25,85,60,25,25,Direct
3462074,125,0,35,195,160,35,35,Direct
3392754,225,0,50,225,175,50,50,Direct
3445762,75,0,35,170,135,35,35,Direct
3462796,200,0,50,315,265,50,50,Direct
3463260,250,0,50,245,195,50,50,Direct
3463303,250,0,25,50,25,25,25,Direct
3463403,125,0,20,130,110,20,20,Direct
3417954,150,0,35,225,190,35,35,Direct
3463989,150,0,10,20,10,10,10,Direct
3462896,125,0,20,75,55,20,20,Direct
3464439,150,0,50,265,215,50,50,Direct
3448713,100,0,20,25,5,20,20,Direct
3464982,100,0,35,145,110,35,35,Direct
3465018,50,0,20,125,105,20,20,Direct
3465025,250,45,20,170,150,20,20,Direct
3465318,350,70,35,190,155,35,35,Direct
3465411,200,0,50,310,260,50,50,Direct
3465718,125,0,50,205,155,50,50,Direct
3461324,200,0,50,200,150,50,50,Direct
3464239,225,0,35,275,240,35,35,Direct
3459016,275,0,35,230,195,35,35,Direct
3455408,250,0,50,240,190,50,50,Direct
3466754,175,0,35,120,85,35,35,Direct
3466997,150,0,35,245,210,35,35,Direct
3467097,125,0,50,220,170,50,50,Direct
3467104,125,0,20,160,140,20,20,Direct
3462017,75,0,25,55,30,25,25,Direct
3467204,125,0,35,240,205,35,35,Direct
3467240,225,15,35,190,155,35,35,Direct
3467383,125,0,25,75,50,25,25,Direct
3467433,100,0,35,165,130,35,35,Direct
3467583,400,115,50,270,220,50,50,Direct
3467933,100,0,35,115,80,35,35,Direct
3467940,200,0,35,140,105,35,35,Direct
3468269,225,15,50,275,225,50,50,Direct
3454931,250,0,25,65,40,25,25,Direct
3465016,75,0,35,165,130,35,35,Direct
3465134,350,90,35,230,195,35,35,Direct
3465577,125,0,35,185,150,35,35,Direct
3460229,125,0,35,125,90,35,35,Direct
3465734,100,0,20,160,140,20,20,Direct
3465963,100,0,50,225,175,50,50,Direct
3459343,275,0,50,225,175,50,50,Direct
3456860,300,90,35,170,135,35,35,Direct
3466756,100,0,50,235,185,50,50,Direct
3466781,275,0,35,190,155,35,35,Direct
3466845,225,0,50,250,200,50,50,Direct
3466831,225,0,20,175,155,20,20,Direct
3467024,125,0,35,140,105,35,35,Direct
3467049,150,0,20,160,140,20,20,Direct
3467138,200,0,35,175,140,35,35,Direct
3467074,225,0,35,170,135,35,35,Direct
3467567,100,0,35,190,155,35,35,Direct
3467606,325,40,50,200,150,50,50,Direct
3467824,300,15,35,125,90,35,35,Direct
3467831,225,15,35,155,120,35,35,Direct
3468160,175,0,35,190,155,35,35,Direct
3468249,125,0,20,80,60,20,20,Direct
3468492,225,15,50,220,170,50,50,Direct
3468567,200,0,50,250,200,50,50,Direct
3468584,350,40,20,120,100,20,20,Direct
3468653,150,0,35,250,215,35,35,Direct
3468717,100,0,50,220,170,50,50,Direct
3467163,325,20,40,275,235,40,40,Direct
3468896,125,0,35,195,160,35,35,Direct
3469346,225,0,35,205,170,35,35,Direct
3469414,250,40,35,205,170,35,35,Direct
3469589,275,20,35,240,205,35,35,Direct
3469678,200,0,35,240,205,35,35,Direct
3408953,200,0,50,220,170,50,50,Direct
3470171,225,0,20,160,140,20,20,Direct
3470414,250,0,20,50,30,20,20,Direct
3470439,200,0,35,155,120,35,35,Direct
3470614,100,0,35,120,85,35,35,Direct
3471168,150,0,25,85,60,25,25,Direct
3460829,25,0,25,65,40,25,25,Direct
3471257,125,0,40,200,160,40,40,Direct
3471325,100,0,20,130,110,20,20,Direct
3471461,650,380,55,460,405,55,55,Direct
3471550,275,90,59,199,140,59,59,Direct
3471725,25,0,20,175,155,20,20,Direct
3471775,125,0,35,165,130,35,35,Direct
3471968,225,30,50,200,150,50,50,Direct
3472129,275,65,35,125,90,35,35,Direct
3450779,125,0,60,155,95,60,60,Direct
3450920,175,0,35,180,145,35,35,Direct
3451286,125,0,35,150,115,35,35,Direct
3453562,175,0,25,80,55,25,25,Direct
3454957,250,0,50,325,275,50,50,Direct
3455021,250,40,35,245,210,35,35,Direct
3455498,175,0,50,155,105,50,50,Direct
3456259,150,0,15,80,65,15,15,Direct
3456293,225,0,35,170,135,35,35,Direct
3456336,300,20,50,275,225,50,50,Direct
3456595,100,0,21,81,60,21,21,Direct
3437777,1775,1075,700,2670,1970,700,700,Direct
3457595,250,40,35,185,150,35,35,Direct
3457770,100,0,35,165,130,35,35,Direct
3457931,50,0,35,225,190,35,35,Direct
3458072,100,0,25,50,25,25,25,Direct
3454196,150,0,20,120,100,20,20,Direct
3449707,275,0,25,95,70,25,25,Direct
3441360,75,0,35,195,160,35,35,Direct
3460314,225,15,50,280,230,50,50,Direct
3460514,175,0,50,250,200,50,50,Direct
3461105,125,0,20,145,125,20,20,Direct
3461480,125,0,25,75,50,25,25,Direct
3461743,100,0,25,90,65,25,25,Direct
3462509,450,170,110,400,290,110,110,Direct
3462752,100,0,50,220,170,50,50,Direct
3463020,175,0,35,190,155,35,35,Direct
3463088,250,0,35,160,125,35,35,Direct
3463211,150,0,50,250,200,50,50,Direct
3463288,175,0,35,150,115,35,35,Direct
3463688,400,145,50,350,300,50,50,Direct
3463854,300,20,50,220,170,50,50,Direct
3464122,50,0,50,225,175,50,50,Direct
3464547,200,0,35,190,155,35,35,Direct
3464556,100,0,60,130,70,60,60,Direct
3470256,100,0,20,95,75,20,20,Direct
3470513,150,0,35,155,120,35,35,Direct
3470726,75,0,35,180,145,35,35,Direct
3470849,250,0,35,170,135,35,35,Direct
3461968,375,70,33,168,135,33,33,Direct
3471485,125,0,50,215,165,50,50,Direct
3471528,100,0,25,80,55,25,25,Direct
3471526,100,0,35,255,220,35,35,Direct
3471628,100,0,35,155,120,35,35,Direct
3471985,225,55,35,195,160,35,35,Direct
3472119,75,0,35,155,120,35,35,Direct
3472128,175,15,50,250,200,50,50,Direct
3455850,100,0,35,125,90,35,35,Direct
3472228,100,0,35,180,145,35,35,Direct
3472219,200,20,24,54,30,24,24,Direct
3472628,175,10,35,150,115,35,35,Direct
3472655,150,0,35,170,135,35,35,Direct
3472662,150,0,50,210,160,50,50,Direct
3472762,100,0,50,220,170,50,50,Direct
3472764,75,0,35,135,100,35,35,Direct
3472898,400,175,50,285,235,50,50,Direct
3472864,175,10,35,160,125,35,35,Direct
3473157,200,30,35,195,160,35,35,Direct
3473198,175,25,50,225,175,50,50,Direct
3473364,350,125,250,500,250,250,250,Direct
3473455,150,0,50,325,275,50,50,Direct
3473500,225,30,33,123,90,33,33,Direct
3473664,100,0,50,235,185,50,50,Direct
3471862,250,45,35,110,75,35,35,Direct
3473698,325,95,50,275,225,50,50,Direct
3473857,250,45,35,245,210,35,35,Direct
3473864,250,55,50,245,195,50,50,Direct
3474491,175,5,20,160,140,20,20,Direct
3474527,75,0,35,140,105,35,35,Direct
3474536,250,50,50,260,210,50,50,Direct
3474836,200,20,35,155,120,35,35,Direct
3474927,300,100,75,345,270,75,75,Direct
3474929,250,45,50,250,200,50,50,Direct
3475034,250,50,25,90,65,25,25,Direct
3475129,200,30,50,325,275,50,50,Direct
3471819,175,10,35,225,190,35,35,Direct
3475563,125,0,35,135,100,35,35,Direct
3475572,200,20,50,220,170,50,50,Direct
3475672,200,30,40,275,235,40,40,Direct
3463039,150,0,35,170,135,35,35,Direct
3459146,175,0,35,190,155,35,35,Direct
3464192,75,0,35,255,220,35,35,Direct
3413103,75,0,25,90,65,25,25,Direct
3438588,25,0,20,140,120,20,20,Direct
3465264,150,0,20,175,155,20,20,Direct
3465396,75,0,35,140,105,35,35,Direct
3465532,225,15,25,65,40,25,25,Direct
3465796,225,0,35,150,115,35,35,Direct
3466217,400,120,50,250,200,50,50,Direct
3456457,225,0,25,60,35,25,25,Direct
3466817,75,0,50,215,165,50,50,Direct
3465128,225,15,35,185,150,35,35,Direct
3466851,75,0,35,140,105,35,35,Direct
3466902,100,0,50,220,170,50,50,Direct
3467102,100,0,20,140,120,20,20,Direct
3467153,1625,1035,550,1605,1055,550,550,Direct
3467251,175,0,35,160,125,35,35,Direct
3467404,225,15,50,265,215,50,50,Direct
3467451,100,0,35,245,210,35,35,Direct
3467838,150,0,35,105,70,35,35,Direct
3467889,400,95,35,155,120,35,35,Direct
3468072,175,0,20,140,120,20,20,Direct
3468455,75,0,50,215,165,50,50,Direct
3468523,200,0,35,150,115,35,35,Direct
3469025,300,0,35,175,140,35,35,Direct
3469042,25,0,35,170,135,35,35,Direct
3469208,75,0,35,155,120,35,35,Direct
3469340,150,0,35,160,125,35,35,Direct
3469608,125,0,20,180,160,20,20,Direct
3469744,1250,825,450,1310,860,450,450,Direct
3470195,100,0,20,75,55,20,20,Direct
3470442,325,20,20,170,150,20,20,Direct
3470476,175,0,35,155,120,35,35,Direct
3470578,150,0,35,150,115,35,35,Direct
3470897,200,0,35,170,135,35,35,Direct
3471612,275,60,50,250,200,50,50,Direct
3471880,225,35,35,110,75,35,35,Direct
3472267,250,50,35,170,135,35,35,Direct
3472382,200,30,35,190,155,35,35,Direct
3472399,575,265,50,380,330,50,50,Direct
3472450,150,0,35,100,65,35,35,Direct
3472816,100,0,20,75,55,20,20,Direct
3472616,450,170,52,257,205,52,52,Direct
3472650,100,0,35,190,155,35,35,Direct
3465248,150,0,50,205,155,50,50,Direct
3465431,100,0,35,200,165,35,35,Direct
3465482,50,0,20,145,125,20,20,Direct
3461804,200,0,50,210,160,50,50,Direct
3465597,125,0,40,205,165,40,40,Direct
3465697,300,15,35,195,160,35,35,Direct
3466769,375,65,35,190,155,35,35,Direct
3466967,75,0,35,235,200,35,35,Direct
3466969,150,0,60,140,80,60,60,Direct
3467033,300,90,20,150,130,20,20,Direct
3467167,225,0,35,135,100,35,35,Direct
3467220,100,0,35,185,150,35,35,Direct
3467218,175,0,20,140,120,20,20,Direct
3467369,500,190,50,340,290,50,50,Direct
3467469,100,0,35,120,85,35,35,Direct
3467654,100,0,40,245,205,40,40,Direct
3467705,225,15,35,155,120,35,35,Direct
3467805,75,0,59,129,70,59,59,Direct
3467803,75,0,25,85,60,25,25,Direct
3468220,425,120,50,215,165,50,50,Direct
3468205,50,0,50,200,150,50,50,Direct
3468405,475,195,50,350,300,50,50,Direct
3467518,150,0,20,160,140,20,20,Direct
3469039,175,0,35,165,130,35,35,Direct
3469190,100,0,25,65,40,25,25,Direct
3469292,75,0,50,225,175,50,50,Direct
3469475,125,0,35,145,110,35,35,Direct
3469575,400,90,35,180,145,35,35,Direct
3469692,125,0,35,180,145,35,35,Direct
3467618,100,0,35,155,120,35,35,Direct
3470228,150,0,35,150,115,35,35,Direct
3470226,225,0,35,165,130,35,35,Direct
3470211,175,0,20,45,25,20,20,Direct
3470392,100,0,50,230,180,50,50,Direct
3470377,100,0,25,80,55,25,25,Direct
3470562,175,0,20,180,160,20,20,Direct
3470628,475,190,125,500,375,125,125,Direct
3470711,175,0,50,200,150,50,50,Direct
3467720,25,0,35,165,130,35,35,Direct
3469690,125,0,35,150,115,35,35,Direct
3468839,175,0,20,95,75,20,20,Direct
3463574,375,65,20,150,130,20,20,Direct
3468056,300,0,35,190,155,35,35,Direct
3469490,250,0,35,225,190,35,35,Direct
3468354,250,0,40,275,235,40,40,Direct
3445526,100,0,35,175,140,35,35,Direct
3471228,100,0,35,155,120,35,35,Direct
3471413,175,10,50,275,225,50,50,Direct
3475963,325,105,40,245,205,40,40,Direct
3472385,100,0,35,115,80,35,35,Direct
3476099,200,40,50,275,225,50,50,Direct
3476129,150,0,25,85,60,25,25,Direct
3476263,300,105,50,225,175,50,50,Direct
3476363,175,5,37,177,140,37,37,Direct
3476406,200,30,20,140,120,20,20,Direct
3476642,225,45,75,330,255,75,75,Direct
3476665,125,0,35,135,100,35,35,Direct
3476899,100,0,50,220,170,50,50,Direct
3477065,300,75,50,275,225,50,50,Direct
3477099,300,90,50,225,175,50,50,Direct
3477344,50,0,20,140,120,20,20,Direct
3477535,225,35,50,210,160,50,50,Direct
3477601,325,105,20,180,160,20,20,Direct
3477635,75,0,35,190,155,35,35,Direct
3477837,175,5,35,260,225,35,35,Direct
3477942,350,105,35,195,160,35,35,Direct
3478042,150,5,50,230,180,50,50,Direct
3478235,150,0,20,35,15,20,20,Direct
3478671,150,0,20,80,60,20,20,Direct
3464433,300,90,50,275,225,50,50,Direct
3457522,175,0,35,190,155,35,35,Direct
3472921,100,0,35,175,140,35,35,Direct
3452208,75,0,35,125,90,35,35,Direct
3479407,100,0,35,155,120,35,35,Direct
3479416,100,0,60,120,60,60,60,Direct
3479709,175,10,35,290,255,35,35,Direct
3479716,225,35,50,375,325,50,50,Direct
3479807,250,65,35,170,135,35,35,Direct
3479816,25,0,19,44,25,19,19,Direct
3479914,100,0,35,180,145,35,35,Direct
3480150,225,35,25,65,40,25,25,Direct
3480643,225,25,50,200,150,50,50,Direct
3480743,350,105,35,150,115,35,35,Direct
3481252,200,25,50,225,175,50,50,Direct
3481245,325,105,35,150,115,35,35,Direct
3452472,250,70,35,195,160,35,35,Direct
3481343,275,65,35,160,125,35,35,Direct
3481445,125,0,35,135,100,35,35,Direct
3481479,100,0,35,175,140,35,35,Direct
3481588,200,20,20,50,30,20,20,Direct
3481786,225,35,50,290,240,50,50,Direct
3481845,225,45,20,75,55,20,20,Direct
3482422,75,0,35,180,145,35,35,Direct
3482624,200,25,35,150,115,35,35,Direct
3449910,300,0,100,200,100,100,100,Direct
3450853,200,0,35,190,155,35,35,Direct
3450024,175,0,35,150,115,35,35,Direct
3443358,125,0,35,190,155,35,35,Direct
3451689,100,0,20,150,130,20,20,Direct
3451682,375,65,35,190,155,35,35,Direct
3452668,250,0,35,150,115,35,35,Direct
3453068,100,0,35,125,90,35,35,Direct
3453125,75,0,35,175,140,35,35,Direct
3453211,100,0,20,85,65,20,20,Direct
3453568,150,0,50,205,155,50,50,Direct
3453961,100,0,90,200,110,90,90,Direct
3447295,100,0,35,225,190,35,35,Direct
3455083,175,0,20,175,155,20,20,Direct
3455440,150,0,50,200,150,50,50,Direct
3455490,125,0,35,250,215,35,35,Direct
3455447,375,90,60,185,125,60,60,Direct
3456033,25,0,25,95,70,25,25,Direct
3457605,125,0,25,55,30,25,25,Direct
3457598,75,0,50,210,160,50,50,Direct
3457648,150,0,35,225,190,35,35,Direct
3457948,125,0,50,345,295,50,50,Direct
3457991,225,15,35,190,155,35,35,Direct
3458834,100,0,20,135,115,20,20,Direct
3459084,150,0,50,250,200,50,50,Direct
3459127,250,40,50,225,175,50,50,Direct
3459177,175,0,35,135,100,35,35,Direct
3459577,100,0,50,210,160,50,50,Direct
3459777,150,0,24,79,55,24,24,Direct
3459784,150,0,35,245,210,35,35,Direct
3460070,275,0,20,75,55,20,20,Direct
3460713,150,0,35,240,205,35,35,Direct
3460906,300,0,50,220,170,50,50,Direct
3461406,125,0,35,155,120,35,35,Direct
3461599,175,0,20,140,120,20,20,Direct
3446272,225,15,50,325,275,50,50,Direct
3446867,250,0,35,260,225,35,35,Direct
3448178,375,65,35,105,70,35,35,Direct
3447846,150,0,35,250,215,35,35,Direct
3448939,175,0,35,245,210,35,35,Direct
3449909,250,0,50,155,105,50,50,Direct
3451020,150,0,35,140,105,35,35,Direct
3451679,300,45,35,140,105,35,35,Direct
3452156,125,0,50,210,160,50,50,Direct
3452249,225,15,35,140,105,35,35,Direct
3453258,150,0,60,135,75,60,60,Direct
3454623,100,0,35,150,115,35,35,Direct
3454789,75,0,35,245,210,35,35,Direct
3455700,150,0,35,240,205,35,35,Direct
3455823,300,20,20,165,145,20,20,Direct
3455959,125,0,20,80,60,20,20,Direct
3456100,75,0,35,245,210,35,35,Direct
3456734,350,40,20,165,145,20,20,Direct
3456636,125,0,35,125,90,35,35,Direct
3459001,150,0,50,235,185,50,50,Direct
3459376,100,0,35,190,155,35,35,Direct
3459669,100,0,55,420,365,55,55,Direct
3459844,275,65,35,265,230,35,35,Direct
3460180,0,0,35,105,70,35,35,Direct
3460512,100,0,5,10,5,5,5,Direct
3460605,325,15,50,265,215,50,50,Direct
3461141,150,0,60,145,85,60,60,Direct
3461380,125,0,20,65,45,20,20,Direct
3449607,250,0,35,135,100,35,35,Direct
3462452,175,30,50,225,175,50,50,Direct
3462720,100,0,35,270,235,35,35,Direct
3463018,125,0,60,105,45,60,60,Direct
3463013,250,40,20,195,175,20,20,Direct
3463111,125,0,45,195,150,45,45,Direct
3463656,200,0,50,215,165,50,50,Direct
3463920,150,0,35,120,85,35,35,Direct
3463988,175,0,20,170,150,20,20,Direct
3464324,150,0,35,150,115,35,35,Direct
3455059,175,0,24,54,30,24,24,Direct
3455378,950,560,370,950,580,370,370,Direct
3456213,250,0,35,100,65,35,35,Direct
3456464,200,0,20,175,155,20,20,Direct
3456599,150,0,25,80,55,25,25,Direct
3456596,0,0,20,105,85,20,20,Direct
3456714,100,0,20,35,15,20,20,Direct
3456999,175,0,35,170,135,35,35,Direct
3457132,175,0,50,270,220,50,50,Direct
3457450,125,0,20,40,20,20,20,Direct
3457850,125,0,35,185,150,35,35,Direct
3441406,75,0,35,175,140,35,35,Direct
3458736,75,0,35,160,125,35,35,Direct
3459590,100,0,35,145,110,35,35,Direct
3460190,50,0,35,140,105,35,35,Direct
3460540,275,65,35,190,155,35,35,Direct
3460658,250,0,50,200,150,50,50,Direct
3460943,250,40,20,80,60,20,20,Direct
3461093,200,0,20,180,160,20,20,Direct
3461429,150,0,20,75,55,20,20,Direct
3461744,225,15,25,75,50,25,25,Direct
3462262,150,0,35,175,140,35,35,Direct
3462530,250,0,35,170,135,35,35,Direct
3461594,125,0,50,255,205,50,50,Direct
3462680,325,15,50,240,190,50,50,Direct
3463101,125,0,50,220,170,50,50,Direct
3453255,100,0,20,145,125,20,20,Direct
3463616,175,0,20,140,120,20,20,Direct
3463901,300,45,50,250,200,50,50,Direct
3464688,550,260,50,350,300,50,50,Direct
3464952,150,0,50,245,195,50,50,Direct
3464969,100,0,20,95,75,20,20,Direct
3465087,175,0,20,170,150,20,20,Direct
3465138,100,0,20,160,140,20,20,Direct
3465288,150,0,35,175,140,35,35,Direct
3465373,100,0,35,195,160,35,35,Direct
3466023,275,15,20,160,140,20,20,Direct
3466406,175,0,50,225,175,50,50,Direct
3465020,50,0,35,170,135,35,35,Direct
3466641,150,0,60,160,100,60,60,Direct
3466709,175,0,20,155,135,20,20,Direct
3466692,275,115,35,175,140,35,35,Direct
3467142,250,0,20,175,155,20,20,Direct
3467227,50,0,35,255,220,35,35,Direct
3467760,100,0,35,120,85,35,35,Direct
3467895,325,20,50,255,205,50,50,Direct
3467946,200,0,35,170,135,35,35,Direct
3468228,125,0,25,90,65,25,25,Direct
3468214,125,0,50,275,225,50,50,Direct
3387311,175,0,25,65,40,25,25,Direct
3462635,425,170,35,260,225,35,35,Direct
3462692,350,40,50,250,200,50,50,Direct
3459927,325,40,35,160,125,35,35,Direct
3463314,400,90,50,250,200,50,50,Direct
3463378,300,20,35,135,100,35,35,Direct
3463564,175,0,35,170,135,35,35,Direct
3463628,150,0,20,75,55,20,20,Direct
3463764,125,0,20,70,50,20,20,Direct
3463814,150,0,50,230,180,50,50,Direct
3464400,125,0,35,145,110,35,35,Direct
3464607,75,0,35,165,130,35,35,Direct
3464171,300,0,50,240,190,50,50,Direct
3465050,100,0,20,185,165,20,20,Direct
3465550,50,0,50,205,155,50,50,Direct
3465586,125,0,35,230,195,35,35,Direct
3465636,475,170,50,235,185,50,50,Direct
3465743,125,0,35,185,150,35,35,Direct
3466093,125,0,50,250,200,50,50,Direct
3466386,125,0,35,225,190,35,35,Direct
3466586,200,0,35,150,115,35,35,Direct
3464114,0,0,15,40,25,15,15,Direct
3451946,125,0,35,140,105,35,35,Direct
3466622,175,0,20,80,60,20,20,Direct
3466672,150,0,35,250,215,35,35,Direct
3466736,175,0,35,165,130,35,35,Direct
3466879,175,0,50,235,185,50,50,Direct
3408269,375,65,35,225,190,35,35,Direct
3467165,25,0,35,125,90,35,35,Direct
3467179,300,15,35,170,135,35,35,Direct
3467258,75,0,5,10,5,5,5,Direct
3467272,250,0,35,155,120,35,35,Direct
3467808,100,0,50,255,205,50,50,Direct
3460456,100,0,35,150,115,35,35,Direct
3467915,400,90,20,165,145,20,20,Direct
3468401,125,0,0,5,5,0,0,Direct
3468837,150,0,50,205,155,50,50,Direct
3469094,300,20,50,210,160,50,50,Direct
3469137,175,0,40,290,250,40,40,Direct
3468994,450,165,50,275,225,50,50,Direct
3469380,125,0,35,155,120,35,35,Direct
3469623,300,20,35,165,130,35,35,Direct
3469723,125,0,20,135,115,20,20,Direct
3469780,225,0,50,200,150,50,50,Direct
3470080,175,0,15,80,65,15,15,Direct
3470130,275,20,35,210,175,35,35,Direct
3470137,50,0,20,85,65,20,20,Direct
3466479,300,0,50,200,150,50,50,Direct
3470666,300,0,20,170,150,20,20,Direct
3471016,175,0,35,190,155,35,35,Direct
3451289,100,0,35,145,110,35,35,Direct
3471466,150,5,35,245,210,35,35,Direct
3468632,125,0,35,165,130,35,35,Direct
3468699,125,0,35,115,80,35,35,Direct
3469300,425,200,110,400,290,110,110,Direct
3469432,300,20,60,190,130,60,60,Direct
3469700,150,0,35,125,90,35,35,Direct
3469767,225,0,25,55,30,25,25,Direct
3469985,125,0,35,150,115,35,35,Direct
3470317,125,0,20,95,75,20,20,Direct
3470385,100,0,35,135,100,35,35,Direct
3418759,225,15,35,250,215,35,35,Direct
3463802,175,0,35,190,155,35,35,Direct
3456314,525,245,75,355,280,75,75,Direct
3467828,75,0,20,50,30,20,20,Direct
3471286,100,0,20,65,45,20,20,Direct
3471440,100,0,35,150,115,35,35,Direct
3471571,125,0,35,180,145,35,35,Direct
3471640,225,45,60,150,90,60,60,Direct
3471758,325,105,20,160,140,20,20,Direct
3471839,275,75,35,165,130,35,35,Direct
3472257,250,60,50,275,225,50,50,Direct
3472239,175,10,35,190,155,35,35,Direct
3472290,250,65,50,275,225,50,50,Direct
3472358,225,50,35,155,120,35,35,Direct
3472525,225,45,35,220,185,35,35,Direct
3472708,150,0,35,170,135,35,35,Direct
3472776,50,0,35,170,135,35,35,Direct
3473362,200,10,50,275,225,50,50,Direct
3473426,200,10,50,280,230,50,50,Direct
3473444,225,35,35,180,145,35,35,Direct
3473562,150,0,35,100,65,35,35,Direct
3474129,250,65,35,150,115,35,35,Direct
3474465,75,0,35,175,140,35,35,Direct
3451183,200,30,35,190,155,35,35,Direct
3474597,175,15,35,190,155,35,35,Direct
3474916,100,0,25,70,45,25,25,Direct
3429191,200,30,20,55,35,20,20,Direct
3450498,200,25,35,155,120,35,35,Direct
3475566,375,140,75,350,275,75,75,Direct
3475634,200,30,35,150,115,35,35,Direct
3475665,125,0,35,140,105,35,35,Direct
3475902,125,0,25,90,65,25,25,Direct
3475933,225,40,60,160,100,60,60,Direct
3476052,75,0,20,110,90,20,20,Direct
3476120,300,100,50,275,225,50,50,Direct
3471363,200,10,20,110,90,20,20,Direct
3471465,175,15,35,190,155,35,35,Direct
3471482,250,65,35,190,155,35,35,Direct
3471529,200,30,50,305,255,50,50,Direct
3471563,600,320,110,460,350,110,110,Direct
3471665,75,0,35,140,105,35,35,Direct
3471716,175,10,50,220,170,50,50,Direct
3452911,125,0,35,170,135,35,35,Direct
3471899,225,25,40,200,160,40,40,Direct
3471933,375,135,50,275,225,50,50,Direct
3472333,300,80,60,155,95,60,60,Direct
3472384,50,0,22,87,65,22,22,Direct
3472401,250,55,50,245,195,50,50,Direct
3472516,125,0,50,235,185,50,50,Direct
3472899,325,95,35,290,255,35,35,Direct
3472916,175,0,35,135,100,35,35,Direct
3473235,200,15,20,80,60,20,20,Direct
3473252,75,0,20,75,55,20,20,Direct
3473418,225,45,35,180,145,35,35,Direct
3473618,325,75,35,150,115,35,35,Direct
3473771,200,20,35,195,160,35,35,Direct
3473805,175,5,50,235,185,50,50,Direct
3473822,50,0,35,170,135,35,35,Direct
3473903,400,140,20,165,145,20,20,Direct
3473954,325,105,35,160,125,35,35,Direct
3474239,250,45,35,170,135,35,35,Direct
3474354,100,0,50,275,225,50,50,Direct
3474741,175,10,35,140,105,35,35,Direct
3474975,200,25,35,190,155,35,35,Direct
3472448,225,35,20,140,120,20,20,Direct
3467538,100,0,20,85,65,20,20,Direct
3466819,275,70,35,240,205,35,35,Direct
3470563,275,80,35,150,115,35,35,Direct
3475256,150,0,25,50,25,25,25,Direct
3475375,175,5,20,40,20,20,20,Direct
3475439,175,10,35,150,115,35,35,Direct
3475609,300,100,75,350,275,75,75,Direct
3475843,200,45,50,225,175,50,50,Direct
3475907,250,50,35,160,125,35,35,Direct
3476175,75,0,20,85,65,20,20,Direct
3476192,150,0,25,85,60,25,25,Direct
3476345,50,0,60,160,100,60,60,Direct
3476379,50,0,50,275,225,50,50,Direct
3476945,150,0,35,280,245,35,35,Direct
3471679,75,0,35,110,75,35,35,Direct
3471696,325,105,35,195,160,35,35,Direct
3471732,75,0,35,135,100,35,35,Direct
3471866,150,0,35,100,65,35,35,Direct
3472066,300,70,35,270,235,35,35,Direct
3472366,175,10,20,170,150,20,20,Direct
3472415,300,75,35,160,125,35,35,Direct
3472481,175,10,75,370,295,75,75,Direct
3472517,300,85,50,275,225,50,50,Direct
3472953,225,40,35,150,115,35,35,Direct
3473053,125,0,35,165,130,35,35,Direct
3473153,175,5,35,160,125,35,35,Direct
3473253,150,0,20,80,60,20,20,Direct
3473402,350,105,40,375,335,40,40,Direct
3473504,225,55,20,95,75,20,20,Direct
3473802,350,120,50,250,200,50,50,Direct
3473904,150,5,50,225,175,50,50,Direct
3473953,225,50,50,220,170,50,50,Direct
3474053,125,0,35,280,245,35,35,Direct
3474153,175,10,20,180,160,20,20,Direct
3474389,175,0,25,80,55,25,25,Direct
3474453,525,195,35,250,215,35,35,Direct
3474804,175,10,37,187,150,37,37,Direct
3433190,125,0,25,90,65,25,25,Direct
3475040,150,0,50,255,205,50,50,Direct
3475159,200,20,60,165,105,60,60,Direct
3474574,200,35,25,70,45,25,25,Direct
3475440,400,160,50,220,170,50,50,Direct
3475525,325,90,50,275,225,50,50,Direct
3475559,350,150,35,270,235,35,35,Direct
3475610,250,45,50,210,160,50,50,Direct
3475776,200,15,20,100,80,20,20,Direct
3475759,175,10,50,250,200,50,50,Direct
3475910,250,45,35,125,90,35,35,Direct
3476161,75,0,50,230,180,50,50,Direct
3476325,150,5,35,190,155,35,35,Direct
3476359,175,10,35,180,145,35,35,Direct
3476412,125,0,20,140,120,20,20,Direct
3476659,225,45,35,175,140,35,35,Direct
3477061,225,35,35,155,120,35,35,Direct
3477097,100,0,50,245,195,50,50,Direct
3477197,475,160,75,385,310,75,75,Direct
3477246,300,70,50,220,170,50,50,Direct
3477431,300,85,75,350,275,75,75,Direct
3477931,275,90,50,280,230,50,50,Direct
3477897,100,0,20,195,175,20,20,Direct
3477882,175,5,50,240,190,50,50,Direct
3477397,75,0,25,85,60,25,25,Direct
3478067,200,10,35,180,145,35,35,Direct
3478197,325,90,50,215,165,50,50,Direct
3478667,225,45,35,150,115,35,35,Direct
3478869,200,20,35,150,115,35,35,Direct
3468283,250,40,50,255,205,50,50,Direct
3468433,375,65,20,175,155,20,20,Direct
3468469,200,0,20,195,175,20,20,Direct
3468569,100,0,50,255,205,50,50,Direct
3468826,150,0,50,200,150,50,50,Direct
3469112,75,0,20,110,90,20,20,Direct
3469369,225,0,20,140,120,20,20,Direct
3469555,400,165,75,315,240,75,75,Direct
3469798,475,220,75,380,305,75,75,Direct
3470255,175,0,35,190,155,35,35,Direct
3470348,275,65,50,275,225,50,50,Direct
3470634,350,40,40,285,245,40,40,Direct
3470934,150,0,50,245,195,50,50,Direct
3468912,50,0,35,170,135,35,35,Direct
3470455,125,0,35,235,200,35,35,Direct
3471327,150,0,20,195,175,20,20,Direct
3471434,200,15,35,230,195,35,35,Direct
3471441,200,30,35,185,150,35,35,Direct
3471677,225,45,35,165,130,35,35,Direct
3471770,250,65,50,225,175,50,50,Direct
3471827,175,15,35,160,125,35,35,Direct
3471920,275,85,35,250,215,35,35,Direct
3471977,225,35,50,255,205,50,50,Direct
3472556,125,0,35,245,210,35,35,Direct
3472756,250,50,20,170,150,20,20,Direct
3472913,250,60,40,255,215,40,40,Direct
3472956,175,5,20,150,130,20,20,Direct
3473106,175,5,50,205,155,50,50,Direct
3473313,75,0,23,58,35,23,23,Direct
3473413,175,5,35,245,210,35,35,Direct
3473599,175,5,35,100,65,35,35,Direct
3473649,75,0,35,135,100,35,35,Direct
3465711,175,10,20,75,55,20,20,Direct
3473806,125,0,50,275,225,50,50,Direct
3474235,200,20,35,110,75,35,35,Direct
3474285,175,10,35,155,120,35,35,Direct
3474342,200,20,35,150,115,35,35,Direct
3474399,100,0,20,70,50,20,20,Direct
3474478,250,65,35,270,235,35,35,Direct
3474828,200,30,110,400,290,110,110,Direct
3475321,200,25,50,375,325,50,50,Direct
3475485,175,15,20,80,60,20,20,Direct
3475614,200,15,35,140,105,35,35,Direct
3475621,275,80,75,350,275,75,75,Direct
3475828,400,135,75,350,275,75,75,Direct
3475864,225,30,35,285,250,35,35,Direct
3475971,75,0,60,195,135,60,60,Direct
3475978,75,0,35,155,120,35,35,Direct
3476207,225,45,50,275,225,50,50,Direct
3475821,175,15,35,170,135,35,35,Direct
3476607,100,0,35,180,145,35,35,Direct
3446464,250,40,35,245,210,35,35,Direct
3446450,300,20,100,230,130,100,100,Direct
3447000,100,0,20,85,65,20,20,Direct
3447093,150,0,20,125,105,20,20,Direct
3442863,175,0,35,135,100,35,35,Direct
3449347,50,0,35,110,75,35,35,Direct
3449751,125,0,35,165,130,35,35,Direct
3450033,250,0,35,155,120,35,35,Direct
3450433,125,0,25,85,60,25,25,Direct
3450569,125,0,60,120,60,60,60,Direct
3436865,125,0,60,155,95,60,60,Direct
3444796,350,40,35,140,105,35,35,Direct
3451423,375,70,50,240,190,50,50,Direct
3451419,0,0,35,180,145,35,35,Direct
3451505,200,0,25,95,70,25,25,Direct
3451530,100,0,25,90,65,25,25,Direct
3451705,150,0,20,175,155,20,20,Direct
3451862,350,40,35,145,110,35,35,Direct
3452130,125,0,50,340,290,50,50,Direct
3452909,150,0,35,210,175,35,35,Direct
3453309,100,0,35,155,120,35,35,Direct
3453484,100,0,35,165,130,35,35,Direct
3453802,75,0,20,80,60,20,20,Direct
3455024,125,0,35,110,75,35,35,Direct
3447118,275,0,35,150,115,35,35,Direct
3456360,125,0,35,185,150,35,35,Direct
3456385,100,0,35,140,105,35,35,Direct
3457103,175,0,35,155,120,35,35,Direct
3457235,200,0,35,250,215,35,35,Direct
3457503,175,0,35,120,85,35,35,Direct
3457546,175,0,50,220,170,50,50,Direct
3454406,50,0,25,60,35,25,25,Direct
3458232,125,0,35,135,100,35,35,Direct
3459018,150,0,60,105,45,60,60,Direct
3467722,275,55,35,150,115,35,35,Direct
3462255,250,105,35,195,160,35,35,Direct
3479233,200,10,20,135,115,20,20,Direct
3479318,175,15,50,325,275,50,50,Direct
3479320,175,20,35,150,115,35,35,Direct
3479369,175,15,35,160,125,35,35,Direct
3479367,225,25,40,235,195,40,40,Direct
3479418,100,0,35,175,140,35,35,Direct
3479454,125,0,40,220,180,40,40,Direct
3479567,200,30,20,170,150,20,20,Direct
3479584,200,35,50,205,155,50,50,Direct
3479684,225,50,50,235,185,50,50,Direct
3479754,175,10,35,250,215,35,35,Direct
3479920,200,0,50,275,225,50,50,Direct
3480239,400,145,75,325,250,75,75,Direct
3480254,50,0,35,125,90,35,35,Direct
3480320,150,0,20,160,140,20,20,Direct
3480356,100,0,20,55,35,20,20,Direct
3480420,325,100,50,275,225,50,50,Direct
3480605,100,0,20,170,150,20,20,Direct
3480690,325,120,75,330,255,75,75,Direct
3390491,150,0,35,290,255,35,35,Direct
3479654,300,85,35,135,100,35,35,Direct
3480890,425,120,75,325,250,75,75,Direct
3481075,175,10,35,150,115,35,35,Direct
3481175,75,0,20,40,20,20,20,Direct
3481590,125,0,35,135,100,35,35,Direct
3482011,75,0,35,190,155,35,35,Direct
3482041,175,5,50,275,225,50,50,Direct
3482128,300,80,50,230,180,50,50,Direct
3482241,75,0,35,175,140,35,35,Direct
3461421,100,0,35,150,115,35,35,Direct
3482428,175,20,35,180,145,35,35,Direct
3479103,75,0,20,170,150,20,20,Direct
3474487,250,65,20,170,150,20,20,Direct
3483447,75,0,35,145,110,35,35,Direct
3484149,250,65,50,230,180,50,50,Direct
3484383,325,115,20,180,160,20,20,Direct
3484698,200,30,50,275,225,50,50,Direct
3485019,50,0,50,245,195,50,50,Direct
3485085,100,0,35,250,215,35,35,Direct
3399751,125,0,35,285,250,35,35,Direct
3485436,1175,700,400,1160,760,400,400,Direct
3485734,175,15,35,250,215,35,35,Direct
3485821,150,5,35,290,255,35,35,Direct
3485855,150,0,20,95,75,20,20,Direct
3486021,275,60,35,125,90,35,35,Direct
3486270,200,30,50,285,235,50,50,Direct
3470002,100,0,20,80,60,20,20,Direct
3470352,275,0,35,165,130,35,35,Direct
3470401,100,0,35,125,90,35,35,Direct
3470452,175,0,20,75,55,20,20,Direct
3470601,175,0,35,125,90,35,35,Direct
3470638,175,0,35,125,90,35,35,Direct
3470837,100,0,20,165,145,20,20,Direct
3468965,100,0,35,190,155,35,35,Direct
3471137,350,45,35,185,150,35,35,Direct
3471388,150,5,20,190,170,20,20,Direct
3455562,175,5,35,165,130,35,35,Direct
3471573,175,10,35,140,105,35,35,Direct
3471587,100,0,50,235,185,50,50,Direct
3471624,325,85,35,175,140,35,35,Direct
3471723,200,10,35,150,115,35,35,Direct
3471788,175,10,55,125,70,55,55,Direct
3472173,250,55,35,135,100,35,35,Direct
3472223,150,0,35,125,90,35,35,Direct
3472259,250,45,35,170,135,35,35,Direct
3472459,50,0,20,85,65,20,20,Direct
3472610,100,0,20,130,110,20,20,Direct
3463850,350,115,35,190,155,35,35,Direct
3472710,300,85,35,150,115,35,35,Direct
3472810,225,45,60,160,100,60,60,Direct
3472960,325,105,65,540,475,65,65,Direct
3473209,175,5,20,170,150,20,20,Direct
3473559,100,0,35,190,155,35,35,Direct
3473995,325,135,50,270,220,50,50,Direct
3474381,100,0,35,245,210,35,35,Direct
3474396,100,0,20,120,100,20,20,Direct
3474482,275,55,20,160,140,20,20,Direct
3474495,100,0,20,65,45,20,20,Direct
3474682,75,0,5,10,5,5,5,Direct
3474696,100,0,35,190,155,35,35,Direct
3402568,275,85,51,211,160,51,51,Direct
3449881,300,100,150,350,200,150,150,Direct
3475367,125,0,50,255,205,50,50,Direct
3475418,475,165,50,255,205,50,50,Direct
3475432,125,0,35,245,210,35,35,Direct
3475467,325,85,35,145,110,35,35,Direct
3475718,175,15,35,190,155,35,35,Direct
3475818,200,30,35,225,190,35,35,Direct
3475867,100,0,35,160,125,35,35,Direct
3476253,100,0,50,200,150,50,50,Direct
3476303,200,35,50,210,160,50,50,Direct
3476353,175,15,35,155,120,35,35,Direct
3476503,200,25,35,175,140,35,35,Direct
3476518,100,0,20,160,140,20,20,Direct
3476554,300,85,35,190,155,35,35,Direct
3476804,100,0,50,200,150,50,50,Direct
3464251,225,0,35,175,140,35,35,Direct
3465137,150,0,35,165,130,35,35,Direct
3465187,125,0,50,235,185,50,50,Direct
3465723,175,0,60,150,90,60,60,Direct
3465838,250,0,50,260,210,50,50,Direct
3466055,275,0,35,190,155,35,35,Direct
3466660,125,0,60,130,70,60,60,Direct
3466842,175,0,50,250,200,50,50,Direct
3467009,225,0,35,160,125,35,35,Direct
3467059,100,0,20,140,120,20,20,Direct
3467110,150,0,20,180,160,20,20,Direct
3467192,225,15,75,385,310,75,75,Direct
3467409,100,0,35,150,115,35,35,Direct
3467446,350,45,35,125,90,35,35,Direct
3467545,100,0,35,110,75,35,35,Direct
3387841,250,0,50,275,225,50,50,Direct
3467745,75,0,35,120,85,35,35,Direct
3468046,100,0,35,190,155,35,35,Direct
3468213,125,0,35,195,160,35,35,Direct
3468195,200,0,35,190,155,35,35,Direct
3468481,250,40,75,335,260,75,75,Direct
3468532,375,65,50,255,205,50,50,Direct
3468314,225,0,50,275,225,50,50,Direct
3468646,100,0,50,275,225,50,50,Direct
3468663,125,0,35,180,145,35,35,Direct
3468732,225,15,50,375,325,50,50,Direct
3468914,100,0,50,200,150,50,50,Direct
3469017,25,0,20,110,90,20,20,Direct
3469331,100,0,25,50,25,25,25,Direct
3469481,100,0,35,140,105,35,35,Direct
3469532,300,20,50,250,200,50,50,Direct
3469599,125,0,50,200,150,50,50,Direct
3395396,400,120,35,200,165,35,35,Direct
3469949,175,0,20,65,45,20,20,Direct
3470000,75,0,25,65,40,25,25,Direct
3470217,150,0,35,230,195,35,35,Direct
3470454,100,0,35,145,110,35,35,Direct
3469281,100,0,35,170,135,35,35,Direct
3470586,550,245,45,375,330,45,45,Direct
3470603,325,45,25,90,65,25,25,Direct
3470885,150,0,50,250,200,50,50,Direct
3470922,275,15,20,190,170,20,20,Direct
3466341,200,0,25,75,50,25,25,Direct
3455295,25,0,35,150,115,35,35,Direct
3400947,200,10,20,175,155,20,20,Direct
3471540,50,0,35,155,120,35,35,Direct
3471722,125,0,20,90,70,20,20,Direct
3471807,225,40,50,220,170,50,50,Direct
3471889,100,0,35,155,120,35,35,Direct
3471922,375,135,35,260,225,35,35,Direct
3471990,8700,7290,900,8295,7395,900,900,Direct
3472075,150,0,35,225,190,35,35,Direct
3472275,125,0,35,180,145,35,35,Direct
3472258,175,0,20,75,55,20,20,Direct
3472339,125,0,50,275,225,50,50,Direct
3472425,150,0,60,195,135,60,60,Direct
3476814,300,115,35,190,155,35,35,Direct
3476950,200,20,35,225,190,35,35,Direct
3477000,250,65,50,245,195,50,50,Direct
3477193,100,0,20,95,75,20,20,Direct
3477343,175,15,20,80,60,20,20,Direct
3477243,125,0,8,13,5,8,8,Direct
3477586,75,0,50,205,155,50,50,Direct
3477593,175,15,35,195,160,35,35,Direct
3477750,250,60,20,180,160,20,20,Direct
3477743,150,5,35,175,140,35,35,Direct
3478043,175,25,50,280,230,50,50,Direct
3478393,225,50,35,125,90,35,35,Direct
3471777,50,0,20,160,140,20,20,Direct
3476700,225,35,50,220,170,50,50,Direct
3479365,125,0,35,190,155,35,35,Direct
3479815,175,0,35,250,215,35,35,Direct
3479858,175,0,40,220,180,40,40,Direct
3480108,275,95,50,255,205,50,50,Direct
3480351,225,40,20,135,115,20,20,Direct
3480344,175,0,50,230,180,50,50,Direct
3449735,200,30,20,90,70,20,20,Direct
3481237,200,15,50,210,160,50,50,Direct
3481201,225,35,60,190,130,60,60,Direct
3481430,175,15,35,125,90,35,35,Direct
3481437,300,100,35,150,115,35,35,Direct
3481580,175,10,35,165,130,35,35,Direct
3481873,650,340,340,840,500,340,340,Direct
3481980,250,65,35,230,195,35,35,Direct
3482130,50,0,20,160,140,20,20,Direct
3482266,175,10,35,175,140,35,35,Direct
3482530,175,10,20,190,170,20,20,Direct
3482730,200,20,50,240,190,50,50,Direct
3482780,225,45,35,200,165,35,35,Direct
3482923,100,0,35,155,120,35,35,Direct
3458659,200,40,20,75,55,20,20,Direct
3483066,150,0,35,150,115,35,35,Direct
3471177,175,0,35,150,115,35,35,Direct
3473906,325,110,35,145,110,35,35,Direct
3483173,225,45,60,120,60,60,60,Direct
3483616,200,20,25,85,60,25,25,Direct
3483859,150,0,35,105,70,35,35,Direct
3483995,175,0,35,265,230,35,35,Direct
3484095,225,40,50,220,170,50,50,Direct
3484695,175,0,50,200,150,50,50,Direct
3484702,175,10,20,155,135,20,20,Direct
3484838,275,85,50,225,175,50,50,Direct
3484895,75,0,50,220,170,50,50,Direct
3484988,175,15,20,160,140,20,20,Direct
3485138,400,140,35,270,235,35,35,Direct
3485224,100,0,20,95,75,20,20,Direct
3485238,175,10,35,100,65,35,35,Direct
3459888,75,0,35,185,150,35,35,Direct
3485717,225,45,50,215,165,50,50,Direct
3429176,125,0,0,5,5,0,0,Direct
3448832,75,0,20,100,80,20,20,Direct
3450066,225,0,50,275,225,50,50,Direct
3363396,125,0,35,250,215,35,35,Direct
3450997,150,0,35,190,155,35,35,Direct
3452240,125,0,60,175,115,60,60,Direct
3452467,75,0,20,190,170,20,20,Direct
3452740,375,90,35,240,205,35,35,Direct
3452876,125,0,35,160,125,35,35,Direct
3453676,100,0,23,53,30,23,23,Direct
3430046,250,0,20,90,70,20,20,Direct
3454705,150,0,25,70,45,25,25,Direct
3408911,150,0,35,190,155,35,35,Direct
3453667,250,40,35,125,90,35,35,Direct
3456018,150,0,25,90,65,25,25,Direct
3456311,200,0,35,195,160,35,35,Direct
3456375,100,0,20,35,15,20,20,Direct
3456411,300,20,35,235,200,35,35,Direct
3457347,150,0,35,210,175,35,35,Direct
3457620,125,0,19,79,60,19,19,Direct
3457713,75,0,35,245,210,35,35,Direct
3457747,300,20,50,275,225,50,50,Direct
3457949,175,0,25,85,60,25,25,Direct
3458785,250,0,50,275,225,50,50,Direct
3459149,225,0,50,200,150,50,50,Direct
3460026,125,0,35,250,215,35,35,Direct
3459985,200,0,50,230,180,50,50,Direct
3460019,150,0,50,220,170,50,50,Direct
3458756,200,0,35,170,135,35,35,Direct
3460255,75,0,35,105,70,35,35,Direct
3421579,325,45,35,190,155,35,35,Direct
3461021,200,0,60,125,65,60,60,Direct
3461155,25,0,35,190,155,35,35,Direct
3461198,100,0,50,250,200,50,50,Direct
3461364,100,0,35,160,125,35,35,Direct
3472954,350,85,50,245,195,50,50,Direct
3472329,350,100,35,175,140,35,35,Direct
3472997,175,15,40,240,200,40,40,Direct
3473265,175,5,35,250,215,35,35,Direct
3473397,250,70,20,175,155,20,20,Direct
3473383,250,45,35,150,115,35,35,Direct
3473440,250,55,20,160,140,20,20,Direct
3473665,200,45,75,300,225,75,75,Direct
3473708,200,35,20,130,110,20,20,Direct
3473976,225,60,50,240,190,50,50,Direct
3474065,125,0,50,270,220,50,50,Direct
3474201,150,0,35,295,260,35,35,Direct
3474294,225,30,25,85,60,25,25,Direct
3474519,175,15,50,240,190,50,50,Direct
3474644,300,90,50,220,170,50,50,Direct
3474719,250,40,35,175,140,35,35,Direct
3474737,75,0,35,150,115,35,35,Direct
3475026,175,5,35,150,115,35,35,Direct
3475112,300,85,35,150,115,35,35,Direct
3475226,200,15,35,190,155,35,35,Direct
3475294,125,0,50,275,225,50,50,Direct
3475430,475,165,35,245,210,35,35,Direct
3475580,375,140,75,350,275,75,75,Direct
3475655,225,0,50,325,275,50,50,Direct
3475698,150,0,35,170,135,35,35,Direct
3475830,75,0,35,150,115,35,35,Direct
3476112,150,0,60,135,75,60,60,Direct
3476430,225,15,50,255,205,50,50,Direct
3476455,150,0,20,160,140,20,20,Direct
3476498,250,40,20,95,75,20,20,Direct
3476541,100,0,35,160,125,35,35,Direct
3477123,175,0,50,275,225,50,50,Direct
3477252,350,135,20,180,160,20,20,Direct
3477409,250,60,50,375,325,50,50,Direct
3477527,125,0,50,235,185,50,50,Direct
3477727,150,0,50,200,150,50,50,Direct
3477834,300,80,40,230,190,40,40,Direct
3477984,100,0,35,155,120,35,35,Direct
3478077,100,0,20,75,55,20,20,Direct
3478238,75,0,35,180,145,35,35,Direct
3478438,150,5,20,140,120,20,20,Direct
3478413,250,55,33,128,95,33,33,Direct
3478545,75,0,35,145,110,35,35,Direct
3478613,100,0,35,165,130,35,35,Direct
3478838,225,45,35,195,160,35,35,Direct
3476859,125,0,20,35,15,20,20,Direct
3479724,150,0,50,225,175,50,50,Direct
3419492,350,105,20,190,170,20,20,Direct
3479906,250,60,37,132,95,37,37,Direct
3479949,175,5,50,280,230,50,50,Direct
3480081,300,110,20,140,120,20,20,Direct
3485624,100,0,35,135,100,35,35,Direct
3486117,250,50,35,195,160,35,35,Direct
3486210,100,0,50,275,225,50,50,Direct
3486310,175,15,35,165,130,35,35,Direct
3486324,300,140,35,195,160,35,35,Direct
3486374,100,0,35,145,110,35,35,Direct
3487067,175,0,50,275,225,50,50,Direct
3487153,300,95,50,275,225,50,50,Direct
3487203,125,0,35,240,205,35,35,Direct
3487253,425,170,50,275,225,50,50,Direct
3487460,200,30,25,95,70,25,25,Direct
3487989,200,15,35,155,120,35,35,Direct
3488089,175,15,50,220,170,50,50,Direct
3488182,175,10,50,275,225,50,50,Direct
3488389,200,30,50,260,210,50,50,Direct
3488382,50,0,35,105,70,35,35,Direct
3467790,200,40,20,190,170,20,20,Direct
3489332,150,0,20,155,135,20,20,Direct
3489368,150,0,20,170,150,20,20,Direct
3489468,50,0,20,170,150,20,20,Direct
3489661,550,235,110,400,290,110,110,Direct
3489768,525,220,125,500,375,125,125,Direct
3489825,200,25,50,245,195,50,50,Direct
3490054,175,10,35,145,110,35,35,Direct
3490218,100,0,35,150,115,35,35,Direct
3490068,275,80,75,360,285,75,75,Direct
3490254,125,0,35,170,135,35,35,Direct
3490268,275,85,35,190,155,35,35,Direct
3491090,225,45,50,230,180,50,50,Direct
3471670,175,0,35,150,115,35,35,Direct
3491147,225,80,60,155,95,60,60,Direct
3491240,425,140,50,325,275,50,50,Direct
3491247,100,0,35,160,125,35,35,Direct
3491340,300,95,40,235,195,40,40,Direct
3491533,150,0,40,250,210,40,40,Direct
3491833,250,60,50,260,210,50,50,Direct
3491890,100,0,20,190,170,20,20,Direct
3491897,200,25,50,375,325,50,50,Direct
3491390,100,0,25,65,40,25,25,Direct
3492090,225,45,35,185,150,35,35,Direct
3492126,200,30,50,220,170,50,50,Direct
3492140,250,40,20,170,150,20,20,Direct
3492340,175,10,35,175,140,35,35,Direct
3492676,325,105,50,200,150,50,50,Direct
3492733,275,75,35,180,145,35,35,Direct
3492819,150,0,35,150,115,35,35,Direct
3487210,175,15,25,50,25,25,25,Direct
3492969,200,10,35,140,105,35,35,Direct
3493276,250,40,50,210,160,50,50,Direct
3493312,200,20,35,175,140,35,35,Direct
3493369,275,85,50,250,200,50,50,Direct
3493462,200,20,20,155,135,20,20,Direct
3493505,200,25,50,210,160,50,50,Direct
3457637,100,0,50,235,185,50,50,Direct
3494005,75,0,35,155,120,35,35,Direct
3494148,225,45,35,170,135,35,35,Direct
3472743,250,25,35,180,145,35,35,Direct
3472808,75,0,50,255,205,50,50,Direct
3472858,275,120,35,190,155,35,35,Direct
3473276,300,70,50,200,150,50,50,Direct
3473293,275,75,110,400,290,110,110,Direct
3471875,475,170,35,250,215,35,35,Direct
3473612,125,0,35,120,85,35,35,Direct
3473693,350,100,50,255,205,50,50,Direct
3473744,125,0,35,250,215,35,35,Direct
3474279,200,15,35,100,65,35,35,Direct
3474679,325,95,35,195,160,35,35,Direct
3474748,175,20,60,195,135,60,60,Direct
3475130,225,40,20,190,170,20,20,Direct
3471153,100,0,35,150,115,35,35,Direct
3473476,350,115,35,180,145,35,35,Direct
3475284,350,100,35,150,115,35,35,Direct
3475283,100,0,37,112,75,37,37,Direct
3475484,375,155,75,350,275,75,75,Direct
3475901,100,0,35,145,110,35,35,Direct
3476283,225,0,35,100,65,35,35,Direct
3476284,25,0,50,210,160,50,50,Direct
3397468,375,125,50,250,200,50,50,Direct
3476470,150,0,33,163,130,33,33,Direct
3476484,150,0,25,85,60,25,25,Direct
3476569,125,0,50,225,175,50,50,Direct
3476701,150,0,60,110,50,60,60,Direct
3404555,100,0,50,230,180,50,50,Direct
3476769,275,55,75,390,315,75,75,Direct
3476819,225,50,35,250,215,35,35,Direct
3476938,75,0,50,200,150,50,50,Direct
3477070,150,0,50,230,180,50,50,Direct
3477223,250,65,50,250,200,50,50,Direct
3477623,100,0,35,170,135,35,35,Direct
3477823,100,0,35,125,90,35,35,Direct
3477841,200,15,35,190,155,35,35,Direct
3477938,250,40,35,110,75,35,35,Direct
3478024,225,25,50,340,290,50,50,Direct
3478023,275,85,20,170,150,20,20,Direct
3478474,100,0,50,280,230,50,50,Direct
3455560,225,35,35,180,145,35,35,Direct
3478760,200,20,20,50,30,20,20,Direct
3478841,225,15,50,275,225,50,50,Direct
3478441,150,0,35,165,130,35,35,Direct
3479309,250,0,50,275,225,50,50,Direct
3479645,100,0,50,225,175,50,50,Direct
3465117,200,0,50,205,155,50,50,Direct
3465726,125,0,35,240,205,35,35,Direct
3465785,200,0,20,155,135,20,20,Direct
3465985,225,0,35,150,115,35,35,Direct
3466453,225,0,20,75,55,20,20,Direct
3465662,175,0,35,180,145,35,35,Direct
3449950,200,0,35,180,145,35,35,Direct
3466687,125,0,25,85,60,25,25,Direct
3466696,400,95,50,265,215,50,50,Direct
3466764,325,45,35,225,190,35,35,Direct
3466789,100,0,35,190,155,35,35,Direct
3466964,400,90,35,170,135,35,35,Direct
3467296,100,0,35,150,115,35,35,Direct
3467355,50,0,25,55,30,25,25,Direct
3467432,225,0,35,165,130,35,35,Direct
3468232,75,0,25,85,60,25,25,Direct
3468393,325,40,20,180,160,20,20,Direct
3468670,150,0,50,275,225,50,50,Direct
3468602,275,65,35,295,260,35,35,Direct
3468895,400,95,35,135,100,35,35,Direct
3468993,200,0,50,275,225,50,50,Direct
3469304,450,140,35,275,240,35,35,Direct
3469670,100,0,15,70,55,15,15,Direct
3469695,550,270,70,600,530,70,70,Direct
3469840,175,0,35,105,70,35,35,Direct
3469295,475,205,75,300,225,75,75,Direct
3470040,125,0,50,265,215,50,50,Direct
3470397,325,70,20,160,140,20,20,Direct
3470406,150,0,50,240,190,50,50,Direct
3470597,125,0,35,155,120,35,35,Direct
3470640,75,0,25,50,25,25,25,Direct
3470776,125,0,36,171,135,36,36,Direct
3456702,175,0,35,145,110,35,35,Direct
3471333,225,45,50,250,200,50,50,Direct
3471342,200,25,25,60,35,25,25,Direct
3471478,200,30,35,165,130,35,35,Direct
3471733,150,0,50,200,150,50,50,Direct
3471776,450,165,35,255,220,35,35,Direct
3471869,225,45,35,150,115,35,35,Direct
3471878,175,20,35,140,105,35,35,Direct
3472044,175,0,50,275,225,50,50,Direct
3472278,125,0,43,153,110,43,43,Direct
3472537,175,0,35,100,65,35,35,Direct
3472644,275,75,35,155,120,35,35,Direct
3472673,100,0,25,90,65,25,25,Direct
3473282,100,0,35,240,205,35,35,Direct
3472878,200,25,50,325,275,50,50,Direct
3473414,325,105,50,190,140,50,50,Direct
3473580,300,100,50,275,225,50,50,Direct
3473614,100,0,25,90,65,25,25,Direct
3473673,250,65,60,130,70,60,60,Direct
3473984,200,20,50,220,170,50,50,Direct
3474150,200,35,50,250,200,50,50,Direct
3473318,325,85,50,250,200,50,50,Direct
3473620,200,20,50,275,225,50,50,Direct
3473701,50,0,35,170,135,35,35,Direct
3473986,250,60,20,180,160,20,20,Direct
3474037,100,0,50,215,165,50,50,Direct
3473786,100,0,60,150,90,60,60,Direct
3474288,200,20,35,195,160,35,35,Direct
3474471,300,105,20,170,150,20,20,Direct
3474539,200,30,35,125,90,35,35,Direct
3458142,175,20,34,124,90,34,34,Direct
3459984,200,25,35,195,160,35,35,Direct
3475390,350,115,35,160,125,35,35,Direct
3475556,325,105,35,165,130,35,35,Direct
3475675,225,30,50,255,205,50,50,Direct
3475692,475,170,50,285,235,50,50,Direct
3475760,100,0,35,145,110,35,35,Direct
3475943,200,30,35,125,90,35,35,Direct
3476075,100,0,35,135,100,35,35,Direct
3476194,150,0,35,180,145,35,35,Direct
3476509,100,0,20,150,130,20,20,Direct
3476560,75,0,35,105,70,35,35,Direct
3476828,200,25,35,290,255,35,35,Direct
3476960,325,120,35,175,140,35,35,Direct
3477479,350,135,50,250,200,50,50,Direct
3477913,50,0,35,140,105,35,35,Direct
3477964,200,10,50,230,180,50,50,Direct
3478164,400,160,35,250,215,35,35,Direct
3475492,50,0,50,235,185,50,50,Direct
3478568,200,30,50,325,275,50,50,Direct
3478581,100,0,35,160,125,35,35,Direct
3478649,25,0,35,250,215,35,35,Direct
3464562,250,50,35,230,195,35,35,Direct
3464162,200,20,50,275,225,50,50,Direct
3479002,150,0,60,120,60,60,60,Direct
3465098,125,0,20,140,120,20,20,Direct
3479287,75,0,35,150,115,35,35,Direct
3479487,375,145,35,200,165,35,35,Direct
3479568,325,0,20,180,160,20,20,Direct
3479853,175,5,20,35,15,20,20,Direct
3480138,225,45,25,75,50,25,25,Direct
3459967,175,10,35,225,190,35,35,Direct
3480406,125,0,35,270,235,35,35,Direct
3480440,175,5,20,175,155,20,20,Direct
3473369,100,0,20,110,90,20,20,Direct
3480589,200,35,50,230,180,50,50,Direct
3480704,175,15,35,125,90,35,35,Direct
3480772,150,0,50,275,225,50,50,Direct
3480955,325,85,50,205,155,50,50,Direct
3481274,125,0,35,105,70,35,35,Direct
3482951,125,0,50,200,150,50,50,Direct
3483081,300,80,50,210,160,50,50,Direct
3483158,225,45,35,185,150,35,35,Direct
3483258,175,10,35,150,115,35,35,Direct
3483317,200,30,50,200,150,50,50,Direct
3469856,75,0,35,115,80,35,35,Direct
3483651,250,0,20,170,150,20,20,Direct
3483658,400,140,20,180,160,20,20,Direct
3483953,200,15,50,280,230,50,50,Direct
3483051,75,0,35,125,90,35,35,Direct
3484053,425,145,50,250,200,50,50,Direct
3484094,125,0,35,260,225,35,35,Direct
3484194,125,0,35,125,90,35,35,Direct
3484387,250,65,20,160,140,20,20,Direct
3484787,150,0,35,150,115,35,35,Direct
3484789,175,10,35,135,100,35,35,Direct
3485030,75,0,35,150,115,35,35,Direct
3485096,100,0,20,75,55,20,20,Direct
3485196,100,0,20,170,150,20,20,Direct
3485189,300,75,35,180,145,35,35,Direct
3426629,475,195,50,250,200,50,50,Direct
3485496,175,15,35,190,155,35,35,Direct
3485523,175,5,35,200,165,35,35,Direct
3485766,100,0,50,275,225,50,50,Direct
3485825,100,0,20,50,30,20,20,Direct
3485925,75,0,35,150,115,35,35,Direct
3485966,150,0,35,190,155,35,35,Direct
3486159,75,0,35,155,120,35,35,Direct
3486761,225,30,75,365,290,75,75,Direct
3486902,225,40,35,190,155,35,35,Direct
3486961,100,0,35,115,80,35,35,Direct
3430471,75,0,35,190,155,35,35,Direct
3487195,250,65,35,150,115,35,35,Direct
3487395,250,45,20,135,115,20,20,Direct
3487468,125,0,35,110,75,35,35,Direct
3487504,100,0,50,235,185,50,50,Direct
3487604,325,90,50,220,170,50,50,Direct
3487897,225,30,35,150,115,35,35,Direct
3488004,175,15,20,175,155,20,20,Direct
3488238,250,70,75,330,255,75,75,Direct
3481688,75,0,35,155,120,35,35,Direct
3488533,300,90,35,215,180,35,35,Direct
3488631,200,30,25,60,35,25,25,Direct
3486125,200,25,60,140,80,60,60,Direct
3488931,350,155,50,220,170,50,50,Direct
3489040,350,100,35,185,150,35,35,Direct
3489067,200,20,20,160,140,20,20,Direct
3471083,75,0,35,155,120,35,35,Direct
3489610,200,30,35,190,155,35,35,Direct
3489674,250,30,35,175,140,35,35,Direct
3471549,275,60,35,175,140,35,35,Direct
3471898,400,210,35,250,215,35,35,Direct
3471913,225,45,35,125,90,35,35,Direct
3472234,75,0,35,180,145,35,35,Direct
3472383,175,10,20,175,155,20,20,Direct
3472398,375,150,50,250,200,50,50,Direct
3472583,350,125,20,160,140,20,20,Direct
3472800,275,90,40,250,210,40,40,Direct
3473085,75,0,50,250,200,50,50,Direct
3473119,125,0,35,150,115,35,35,Direct
3473270,25,0,35,125,90,35,35,Direct
3473370,75,0,50,255,205,50,50,Direct
3471198,100,0,20,75,55,20,20,Direct
3473385,350,155,80,790,710,80,80,Direct
3473485,100,0,35,100,65,35,35,Direct
3473736,150,0,35,155,120,35,35,Direct
3473855,125,0,35,185,150,35,35,Direct
3473885,100,0,10,15,5,10,10,Direct
3473919,200,35,35,100,65,35,35,Direct
3474421,75,0,20,95,75,20,20,Direct
3474655,100,0,20,160,140,20,20,Direct
3474772,75,0,50,375,325,50,50,Direct
3474957,150,0,50,275,225,50,50,Direct
3475091,200,20,50,290,240,50,50,Direct
3457524,125,0,35,150,115,35,35,Direct
3475442,350,100,35,190,155,35,35,Direct
3475857,175,5,25,50,25,25,25,Direct
3475908,275,65,20,90,70,20,20,Direct
3475991,175,0,60,155,95,60,60,Direct
3476091,50,0,35,140,105,35,35,Direct
3423147,75,0,20,170,150,20,20,Direct
3476429,200,25,35,255,220,35,35,Direct
3476629,225,45,50,275,225,50,50,Direct
3477163,200,25,35,145,110,35,35,Direct
3477329,275,80,35,105,70,35,35,Direct
3477599,100,0,35,150,115,35,35,Direct
3477716,125,0,20,180,160,20,20,Direct
3477763,175,10,20,160,140,20,20,Direct
3477799,175,0,20,195,175,20,20,Direct
3477980,50,0,35,150,115,35,35,Direct
3478114,225,40,50,220,170,50,50,Direct
3478314,100,0,35,150,115,35,35,Direct
3478465,100,0,50,200,150,50,50,Direct
3479601,350,115,35,180,145,35,35,Direct
3479637,250,45,20,160,140,20,20,Direct
3476337,300,70,40,260,220,40,40,Direct
3476451,100,0,60,120,60,60,60,Direct
3476537,950,645,80,750,670,80,80,Direct
3476702,75,0,20,55,35,20,20,Direct
3477038,100,0,20,160,140,20,20,Direct
3477187,200,40,25,95,70,25,25,Direct
3477337,450,170,50,225,175,50,50,Direct
3477537,125,0,35,180,145,35,35,Direct
3454541,1675,1215,325,2000,1675,325,325,Direct
3477873,50,0,35,180,145,35,35,Direct
3478192,100,0,20,65,45,20,20,Direct
3478391,225,35,60,100,40,60,60,Direct
3478523,175,15,25,55,30,25,25,Direct
3478842,100,0,35,190,155,35,35,Direct
3478924,100,0,20,160,140,20,20,Direct
3478927,225,45,50,275,225,50,50,Direct
3450983,275,90,35,190,155,35,35,Direct
3479259,125,0,35,105,70,35,35,Direct
3479310,125,0,20,190,170,20,20,Direct
3479409,375,150,55,405,350,55,55,Direct
3479460,75,0,35,190,155,35,35,Direct
3479528,175,10,35,155,120,35,35,Direct
3479609,200,25,20,75,55,20,20,Direct
3479745,250,50,75,320,245,75,75,Direct
3479795,275,65,35,180,145,35,35,Direct
3479813,225,45,35,140,105,35,35,Direct
3480060,50,0,35,170,135,35,35,Direct
3480114,225,40,35,170,135,35,35,Direct
3480264,225,35,35,135,100,35,35,Direct
3479945,300,115,35,260,225,35,35,Direct
3480663,225,80,35,190,155,35,35,Direct
3480813,100,0,50,275,225,50,50,Direct
3481217,325,110,50,295,245,50,50,Direct
3481332,200,0,50,210,160,50,50,Direct
3481464,125,0,35,115,80,35,35,Direct
3481468,225,30,35,150,115,35,35,Direct
3481782,75,0,20,130,110,20,20,Direct
3481850,250,60,35,160,125,35,35,Direct
3481885,50,0,60,195,135,60,60,Direct
3482135,200,25,40,210,170,40,40,Direct
3482153,400,155,110,415,305,110,110,Direct
3439165,200,35,35,170,135,35,35,Direct
3482200,175,20,60,105,45,60,60,Direct
3482268,200,20,35,205,170,35,35,Direct
3482604,100,0,35,180,145,35,35,Direct
3482718,75,0,60,150,90,60,60,Direct
3482885,75,0,35,150,115,35,35,Direct
3473044,100,0,20,180,160,20,20,Direct
3490310,175,5,35,245,210,35,35,Direct
3490376,125,0,20,75,55,20,20,Direct
3490412,175,20,35,195,160,35,35,Direct
3467739,150,0,20,130,110,20,20,Direct
3490812,150,0,35,125,90,35,35,Direct
3490905,175,0,50,325,275,50,50,Direct
3484196,200,10,35,250,215,35,35,Direct
3477042,125,0,35,230,195,35,35,Direct
3491103,175,15,35,175,140,35,35,Direct
3491239,25,0,50,200,150,50,50,Direct
3491382,300,75,35,190,155,35,35,Direct
3491548,75,0,20,180,160,20,20,Direct
3491541,375,125,75,340,265,75,75,Direct
3491639,125,0,35,180,145,35,35,Direct
3492075,200,35,33,173,140,33,33,Direct
3477399,175,10,20,160,140,20,20,Direct
3492175,100,0,35,250,215,35,35,Direct
3492384,325,120,35,270,235,35,35,Direct
3492518,325,90,50,275,225,50,50,Direct
3492577,75,0,35,170,135,35,35,Direct
3492677,275,85,50,280,230,50,50,Direct
3492784,275,55,50,275,225,50,50,Direct
3493084,175,10,27,77,50,27,27,Direct
3493518,275,80,20,105,85,20,20,Direct
3493747,350,100,35,280,245,35,35,Direct
3493920,175,10,35,165,130,35,35,Direct
3494256,225,45,25,80,55,25,25,Direct
3494347,200,30,50,200,150,50,50,Direct
3494747,200,35,20,180,160,20,20,Direct
3494756,175,5,50,215,165,50,50,Direct
3494992,200,20,75,375,300,75,75,Direct
3495549,450,165,35,260,225,35,35,Direct
3456752,75,0,35,125,90,35,35,Direct
3466946,100,0,50,230,180,50,50,Direct
3495792,175,10,75,300,225,75,75,Direct
3495928,175,15,35,245,210,35,35,Direct
3496026,350,115,50,290,240,50,50,Direct
3496262,175,10,20,180,160,20,20,Direct
3496362,175,15,35,120,85,35,35,Direct
3496526,325,105,75,375,300,75,75,Direct
3496621,75,0,35,160,125,35,35,Direct
3496728,125,0,25,95,70,25,25,Direct
3496785,125,0,35,225,190,35,35,Direct
3496921,150,0,35,150,115,35,35,Direct
3497121,325,105,50,240,190,50,50,Direct
3496955,100,0,35,170,135,35,35,Direct
3497164,225,55,35,160,125,35,35,Direct
3470283,250,45,20,170,150,20,20,Direct
3497462,150,0,100,230,130,100,100,Direct
3459779,100,0,50,300,250,50,50,Direct
3460247,300,85,35,250,215,35,35,Direct
3460647,75,0,36,111,75,36,36,Direct
3460640,75,0,35,150,115,35,35,Direct
3460972,250,0,20,105,85,20,20,Direct
3461090,50,0,50,235,185,50,50,Direct
3461108,250,40,50,340,290,50,50,Direct
3461397,150,0,50,250,200,50,50,Direct
3445539,175,0,35,150,115,35,35,Direct
3462469,375,65,35,175,140,35,35,Direct
3462519,100,0,25,75,50,25,25,Direct
3462762,200,0,35,145,110,35,35,Direct
3463055,75,0,60,120,60,60,60,Direct
3463780,375,65,35,150,115,35,35,Direct
3463830,400,115,35,270,235,35,35,Direct
3463873,375,65,50,275,225,50,50,Direct
3464030,225,15,35,140,105,35,35,Direct
3462976,200,50,35,145,110,35,35,Direct
3464366,75,0,35,125,90,35,35,Direct
3464673,150,0,35,225,190,35,35,Direct
3456903,325,15,35,160,125,35,35,Direct
3465209,225,0,20,85,65,20,20,Direct
3465259,325,40,35,220,185,35,35,Direct
3465316,275,0,20,160,140,20,20,Direct
3465384,125,0,35,175,140,35,35,Direct
3465459,125,0,35,245,210,35,35,Direct
3465677,75,0,50,250,200,50,50,Direct
3465702,300,20,50,200,150,50,50,Direct
3465984,300,20,60,165,105,60,60,Direct
3465995,125,0,35,195,160,35,35,Direct
3466145,100,0,35,145,110,35,35,Direct
3466477,125,0,35,150,115,35,35,Direct
3466588,100,0,35,190,155,35,35,Direct
3466945,125,0,25,50,25,25,25,Direct
3466999,225,0,60,125,65,60,60,Direct
3467174,75,0,20,80,60,20,20,Direct
3467188,100,0,25,90,65,25,25,Direct
3467263,75,0,20,175,155,20,20,Direct
3467524,400,115,35,155,120,35,35,Direct
3467881,175,0,50,210,160,50,50,Direct
3468460,100,0,35,140,105,35,35,Direct
3455606,225,0,20,35,15,20,20,Direct
3468535,150,0,20,175,155,20,20,Direct
3468660,150,0,60,100,40,60,60,Direct
3468667,175,0,50,225,175,50,50,Direct
3468735,150,0,60,135,75,60,60,Direct
3468803,100,0,20,95,75,20,20,Direct
3468928,250,0,35,160,125,35,35,Direct
3469196,225,0,35,140,105,35,35,Direct
3469203,25,0,20,190,170,20,20,Direct
3480460,200,15,20,160,140,20,20,Direct
3481003,100,0,60,145,85,60,60,Direct
3481153,175,25,20,140,120,20,20,Direct
3481178,75,0,35,155,120,35,35,Direct
3481396,100,0,35,255,220,35,35,Direct
3481510,200,15,50,230,180,50,50,Direct
3481596,175,5,25,90,65,25,25,Direct
3481646,175,10,35,290,255,35,35,Direct
3481664,200,40,50,265,215,50,50,Direct
3481821,200,20,35,135,100,35,35,Direct
3481953,200,15,35,290,255,35,35,Direct
3482046,300,95,35,260,225,35,35,Direct
3482182,175,10,20,35,15,20,20,Direct
3482221,75,0,35,165,130,35,35,Direct
3482246,50,0,10,15,5,10,10,Direct
3482396,175,0,35,115,80,35,35,Direct
3482407,475,170,75,335,260,75,75,Direct
3482464,125,0,20,65,45,20,20,Direct
3482514,175,10,35,105,70,35,35,Direct
3482607,200,30,50,210,160,50,50,Direct
3482757,0,0,20,160,140,20,20,Direct
3473129,275,70,20,195,175,20,20,Direct
3483200,275,90,35,225,190,35,35,Direct
3483407,200,25,40,250,210,40,40,Direct
3483611,200,15,50,240,190,50,50,Direct
3483736,100,0,25,65,40,25,25,Direct
3483761,100,0,50,205,155,50,50,Direct
3483936,175,20,50,260,210,50,50,Direct
3483961,325,90,50,290,240,50,50,Direct
3484011,150,0,50,225,175,50,50,Direct
3484143,150,5,25,75,50,25,25,Direct
3484268,150,0,25,55,30,25,25,Direct
3484468,75,0,50,225,175,50,50,Direct
3484679,125,0,35,150,115,35,35,Direct
3484493,175,15,35,135,100,35,35,Direct
3484479,100,0,35,190,155,35,35,Direct
3484522,100,0,35,105,70,35,35,Direct
3484629,200,30,50,250,200,50,50,Direct
3484829,50,0,50,210,160,50,50,Direct
3484811,75,0,50,235,185,50,50,Direct
3485140,25,0,20,50,30,20,20,Direct
3485740,50,0,50,210,160,50,50,Direct
3485547,250,50,35,130,95,35,35,Direct
3486283,25,0,35,235,200,35,35,Direct
3486433,275,65,20,160,140,20,20,Direct
3486458,100,0,20,95,75,20,20,Direct
3486819,125,0,35,160,125,35,35,Direct
3481372,250,45,35,265,230,35,35,Direct
3481491,75,0,35,150,115,35,35,Direct
3481691,75,0,35,130,95,35,35,Direct
3481759,300,80,35,185,150,35,35,Direct
3481840,300,100,60,185,125,60,60,Direct
3481976,225,60,50,275,225,50,50,Direct
3481993,175,5,35,250,215,35,35,Direct
3482091,300,100,20,190,170,20,20,Direct
3482278,275,60,50,220,170,50,50,Direct
3482376,175,10,20,35,15,20,20,Direct
3482427,125,0,20,75,55,20,20,Direct
3482478,200,30,50,220,170,50,50,Direct
3482542,175,5,50,275,225,50,50,Direct
3483146,200,30,20,175,155,20,20,Direct
3483180,200,15,35,150,115,35,35,Direct
3483997,200,20,50,345,295,50,50,Direct
3484014,200,35,35,160,125,35,35,Direct
3484116,175,15,35,240,205,35,35,Direct
3484248,75,0,35,100,65,35,35,Direct
3484282,75,0,35,125,90,35,35,Direct
3484384,50,0,50,240,190,50,50,Direct
3484516,375,150,50,205,155,50,50,Direct
3484767,100,0,35,155,120,35,35,Direct
3484933,75,0,20,75,55,20,20,Direct
3485035,300,100,110,400,290,110,110,Direct
3485069,250,50,35,245,210,35,35,Direct
3485584,200,20,35,190,155,35,35,Direct
3485652,100,0,50,200,150,50,50,Direct
3486120,100,0,35,160,125,35,35,Direct
3486188,325,85,35,145,110,35,35,Direct
3486286,150,0,35,160,125,35,35,Direct
3486371,200,35,35,150,115,35,35,Direct
3479351,100,0,35,160,125,35,35,Direct
3486473,225,60,60,175,115,60,60,Direct
3486771,125,0,35,135,100,35,35,Direct
3487141,175,5,35,205,170,35,35,Direct
3487192,150,5,35,165,130,35,35,Direct
3487188,275,60,35,250,215,35,35,Direct
3487290,225,35,35,245,210,35,35,Direct
3487456,225,45,40,310,270,40,40,Direct
3487643,75,0,50,250,200,50,50,Direct
3487690,325,100,50,275,225,50,50,Direct
3487724,125,0,50,375,325,50,50,Direct
3487843,75,0,35,165,130,35,35,Direct
3487775,250,45,50,230,180,50,50,Direct
3488260,175,5,35,175,140,35,35,Direct
3488311,75,0,35,180,145,35,35,Direct
3392949,375,120,50,230,180,50,50,Direct
3488426,225,45,50,355,305,50,50,Direct
3488894,200,15,35,105,70,35,35,Direct
3488996,100,0,35,160,125,35,35,Direct
3489077,275,60,20,160,140,20,20,Direct
3494155,250,50,35,180,145,35,35,Direct
3494305,125,0,35,150,115,35,35,Direct
3494362,125,0,35,150,115,35,35,Direct
3494398,175,5,75,325,250,75,75,Direct
3494462,225,35,50,275,225,50,50,Direct
3494491,175,10,35,125,90,35,35,Direct
3494555,250,65,100,200,100,100,100,Direct
3494591,275,95,50,205,155,50,50,Direct
3494691,100,0,25,60,35,25,25,Direct
3494698,275,75,35,125,90,35,35,Direct
3494798,175,5,35,195,160,35,35,Direct
3494955,125,0,50,280,230,50,50,Direct
3494984,200,25,50,205,155,50,50,Direct
3495041,200,25,35,185,150,35,35,Direct
3495134,600,265,50,325,275,50,50,Direct
3486853,200,20,20,130,110,20,20,Direct
3495741,50,0,35,100,65,35,35,Direct
3495777,100,0,35,160,125,35,35,Direct
3496284,200,20,50,325,275,50,50,Direct
3496370,125,0,35,165,130,35,35,Direct
3496427,200,35,50,375,325,50,50,Direct
3496770,100,0,50,200,150,50,50,Direct
3496863,125,0,50,200,150,50,50,Direct
3497313,150,0,35,195,160,35,35,Direct
3498099,175,10,35,225,190,35,35,Direct
3498299,150,0,35,180,145,35,35,Direct
3498335,400,140,50,250,200,50,50,Direct
3498492,175,10,35,130,95,35,35,Direct
3498842,225,35,60,105,45,60,60,Direct
3498878,250,40,20,110,90,20,20,Direct
3487689,100,0,35,140,105,35,35,Direct
3459059,375,120,50,295,245,50,50,Direct
3500271,100,0,35,175,140,35,35,Direct
3500371,200,30,50,225,175,50,50,Direct
3500750,150,5,50,225,175,50,50,Direct
3501150,125,0,60,190,130,60,60,Direct
3501643,325,90,50,200,150,50,50,Direct
3501657,150,5,25,85,60,25,25,Direct
3456901,175,10,35,170,135,35,35,Direct
3501743,300,90,35,250,215,35,35,Direct
3501900,50,0,35,170,135,35,35,Direct
3501850,100,0,25,85,60,25,25,Direct
3501893,250,50,35,190,155,35,35,Direct
3501993,225,35,50,165,115,50,50,Direct
3502036,200,25,20,110,90,20,20,Direct
3502186,175,10,35,205,170,35,35,Direct
3502200,100,0,35,165,130,35,35,Direct
3502536,250,60,35,190,155,35,35,Direct
3502593,150,0,50,205,155,50,50,Direct
3502786,200,30,35,175,140,35,35,Direct
3503122,100,0,35,150,115,35,35,Direct
3503222,75,0,35,245,210,35,35,Direct
3503279,125,0,35,165,130,35,35,Direct
3469310,175,0,35,165,130,35,35,Direct
3469646,100,0,35,180,145,35,35,Direct
3469778,175,0,35,180,145,35,35,Direct
3469821,200,0,35,165,130,35,35,Direct
3470357,100,0,50,255,205,50,50,Direct
3470450,250,0,60,170,110,60,60,Direct
3470557,200,0,35,180,145,35,35,Direct
3450501,175,0,20,170,150,20,20,Direct
3448136,225,0,36,136,100,36,36,Direct
3471668,275,60,50,245,195,50,50,Direct
3471786,225,35,58,178,120,58,58,Direct
3471868,200,20,35,245,210,35,35,Direct
3472004,300,100,35,190,155,35,35,Direct
3472118,100,0,60,140,80,60,60,Direct
3472318,175,10,35,175,140,35,35,Direct
3472454,300,15,20,160,140,20,20,Direct
3472804,100,0,20,160,140,20,20,Direct
3472922,225,45,35,135,100,35,35,Direct
3473029,75,0,35,140,105,35,35,Direct
3473140,225,35,50,220,170,50,50,Direct
3473229,200,25,50,225,175,50,50,Direct
3473497,175,5,50,215,165,50,50,Direct
3450994,250,65,35,180,145,35,35,Direct
3463337,225,45,40,210,170,40,40,Direct
3473747,100,0,35,140,105,35,35,Direct
3473876,200,25,21,96,75,21,21,Direct
3473926,150,0,35,165,130,35,35,Direct
3473940,200,20,35,180,145,35,35,Direct
3474190,200,15,50,225,175,50,50,Direct
3474351,275,45,20,170,150,20,20,Direct
3474458,200,35,50,295,245,50,50,Direct
3474526,250,40,20,150,130,20,20,Direct
3472472,325,120,35,180,145,35,35,Direct
3471811,375,120,40,280,240,40,40,Direct
3475594,200,25,20,190,170,20,20,Direct
3475637,325,85,50,210,160,50,50,Direct
3475687,275,55,50,335,285,50,50,Direct
3475823,150,0,35,240,205,35,35,Direct
3475862,125,0,40,210,170,40,40,Direct
3476173,150,0,20,125,105,20,20,Direct
3476223,300,75,35,120,85,35,35,Direct
3476280,475,165,75,305,230,75,75,Direct
3476373,475,190,50,290,240,50,50,Direct
3476330,200,25,35,190,155,35,35,Direct
3476398,75,0,60,120,60,60,60,Direct
3476759,250,50,50,275,225,50,50,Direct
3471552,175,0,35,245,210,35,35,Direct
3471802,125,0,50,225,175,50,50,Direct
3471852,325,105,50,220,170,50,50,Direct
3471952,75,0,35,175,140,35,35,Direct
3472252,200,40,35,110,75,35,35,Direct
3472302,250,65,50,260,210,50,50,Direct
3472295,100,0,35,105,70,35,35,Direct
3472102,400,140,40,265,225,40,40,Direct
3473131,50,0,35,150,115,35,35,Direct
3473124,100,0,20,160,140,20,20,Direct
3473238,150,0,50,325,275,50,50,Direct
3473231,550,280,110,450,340,110,110,Direct
3473767,625,250,50,375,325,50,50,Direct
3473981,100,0,35,135,100,35,35,Direct
3474367,150,0,20,180,160,20,20,Direct
3474553,75,0,35,150,115,35,35,Direct
3474767,75,0,20,85,65,20,20,Direct
3475010,175,10,35,125,90,35,35,Direct
3475053,225,30,35,285,250,35,35,Direct
3473474,175,5,35,175,140,35,35,Direct
3450846,175,10,50,215,165,50,50,Direct
3475546,350,120,75,350,275,75,75,Direct
3475639,400,140,50,220,170,50,50,Direct
3475689,150,0,35,150,115,35,35,Direct
3475696,150,0,50,325,275,50,50,Direct
3475739,425,115,50,385,335,50,50,Direct
3475753,175,15,20,170,150,20,20,Direct
3476139,450,145,52,277,225,52,52,Direct
3476182,200,30,50,375,325,50,50,Direct
3476189,175,15,35,150,115,35,35,Direct
3476239,125,0,35,125,90,35,35,Direct
3476382,275,90,35,180,145,35,35,Direct
3476482,175,20,50,230,180,50,50,Direct
3476975,175,20,35,175,140,35,35,Direct
3477032,175,5,40,230,190,40,40,Direct
3477125,200,0,50,375,325,50,50,Direct
3477182,225,45,35,170,135,35,35,Direct
3461049,125,0,35,155,120,35,35,Direct
3477368,275,60,50,230,180,50,50,Direct
3477418,100,0,20,85,65,20,20,Direct
3477468,425,115,50,200,150,50,50,Direct
3477711,225,35,75,385,310,75,75,Direct
3477818,200,25,20,120,100,20,20,Direct
3477961,225,45,50,220,170,50,50,Direct
3478154,250,40,35,150,115,35,35,Direct
3478211,225,45,35,160,125,35,35,Direct
3478697,375,120,20,175,155,20,20,Direct
3479104,75,0,35,225,190,35,35,Direct
3478204,50,0,35,165,130,35,35,Direct
3477230,200,30,50,250,200,50,50,Direct
3477264,225,50,15,70,55,15,15,Direct
3477281,175,5,20,40,20,20,20,Direct
3477328,125,0,35,115,80,35,35,Direct
3477881,125,0,35,120,85,35,35,Direct
3478047,225,45,20,175,155,20,20,Direct
3478149,200,35,20,160,140,20,20,Direct
3478434,175,10,35,265,230,35,35,Direct
3478366,175,10,50,250,200,50,50,Direct
3478634,100,0,20,65,45,20,20,Direct
3478715,50,0,35,195,160,35,35,Direct
3478749,300,75,35,165,130,35,35,Direct
3478932,75,0,35,225,190,35,35,Direct
3478949,175,5,20,115,95,20,20,Direct
3479017,275,65,125,500,375,125,125,Direct
3462271,75,0,5,10,5,5,5,Direct
3385559,100,0,35,175,140,35,35,Direct
3479353,325,75,50,235,185,50,50,Direct
3479404,175,10,50,225,175,50,50,Direct
3479970,75,0,50,200,150,50,50,Direct
3407489,250,65,50,230,180,50,50,Direct
3480472,125,0,35,160,125,35,35,Direct
3480570,300,70,35,250,215,35,35,Direct
3480557,150,0,60,195,135,60,60,Direct
3480774,325,135,50,235,185,50,50,Direct
3481038,125,0,50,230,180,50,50,Direct
3481055,25,0,35,125,90,35,35,Direct
3481157,175,5,60,135,75,60,60,Direct
3481242,175,15,35,135,100,35,35,Direct
3481357,250,55,20,150,130,20,20,Direct
3482059,125,0,35,135,100,35,35,Direct
3461420,325,85,150,385,235,150,150,Direct
3482178,75,0,35,180,145,35,35,Direct
3482578,275,85,75,355,280,75,75,Direct
3482676,50,0,20,95,75,20,20,Direct
3482727,200,30,35,140,105,35,35,Direct
3482944,100,0,50,295,245,50,50,Direct
3483144,300,100,35,265,230,35,35,Direct
3483280,125,0,35,155,120,35,35,Direct
3483395,325,90,60,180,120,60,60,Direct
3483446,200,25,50,205,155,50,50,Direct
3483514,100,0,35,295,260,35,35,Direct
3483195,300,85,35,260,225,35,35,Direct
3483812,175,15,35,120,85,35,35,Direct
3483846,175,10,35,170,135,35,35,Direct
3483914,225,50,75,360,285,75,75,Direct
3483965,175,10,50,150,100,50,50,Direct
3484050,125,0,35,190,155,35,35,Direct
3484148,200,10,40,200,160,40,40,Direct
3484215,200,20,40,200,160,40,40,Direct
3484331,75,0,35,155,120,35,35,Direct
3484718,200,30,110,400,290,110,110,Direct
3484969,275,65,35,150,115,35,35,Direct
3497721,75,0,35,255,220,35,35,Direct
3497757,125,0,20,140,120,20,20,Direct
3497764,100,0,60,100,40,60,60,Direct
3498200,275,70,40,305,265,40,40,Direct
3498234,225,45,50,205,155,50,50,Direct
3429401,175,30,60,170,110,60,60,Direct
3498800,100,0,35,195,160,35,35,Direct
3499093,250,65,35,150,115,35,35,Direct
3499293,300,60,35,150,115,35,35,Direct
3499627,175,5,20,80,60,20,20,Direct
3495190,175,5,20,85,65,20,20,Direct
3499872,150,0,35,250,215,35,35,Direct
3500106,275,95,50,285,235,50,50,Direct
3500136,250,50,50,250,200,50,50,Direct
3500172,175,10,20,55,35,20,20,Direct
3500363,200,20,35,140,105,35,35,Direct
3500572,75,0,35,270,235,35,35,Direct
3500606,200,30,35,290,255,35,35,Direct
3501299,175,5,40,290,250,40,40,Direct
3501306,75,0,15,85,70,15,15,Direct
3501365,75,0,35,275,240,35,35,Direct
3501406,150,5,20,180,160,20,20,Direct
3501635,250,75,35,150,115,35,35,Direct
3501878,100,0,35,260,225,35,35,Direct
3502178,225,25,35,150,115,35,35,Direct
3502237,275,70,50,275,225,50,50,Direct
3502737,525,270,110,455,345,110,110,Direct
3502944,225,55,35,125,90,35,35,Direct
3503037,175,0,35,160,125,35,35,Direct
3503307,350,120,50,220,170,50,50,Direct
3503371,575,280,110,415,305,110,110,Direct
3503850,200,10,50,250,200,50,50,Direct
3504050,150,0,50,200,150,50,50,Direct
3504216,75,0,50,275,225,50,50,Direct
3504409,150,0,60,115,55,60,60,Direct
3504650,100,0,35,125,90,35,35,Direct
3504716,125,0,50,235,185,50,50,Direct
3504750,250,5,35,100,65,35,35,Direct
3504950,100,0,50,275,225,50,50,Direct
3505252,100,0,35,110,75,35,35,Direct
3505386,175,15,60,160,100,60,60,Direct
3505479,150,0,35,125,90,35,35,Direct
3505579,350,130,50,225,175,50,50,Direct
3505643,125,0,35,105,70,35,35,Direct
3505743,275,65,50,325,275,50,50,Direct
3505788,400,160,50,265,215,50,50,Direct
3505822,150,0,50,200,150,50,50,Direct
3505922,50,0,35,150,115,35,35,Direct
3505981,175,10,20,155,135,20,20,Direct
3506045,225,45,50,265,215,50,50,Direct
3506381,300,85,20,155,135,20,20,Direct
3506488,275,85,35,125,90,35,35,Direct
3489362,300,75,50,260,210,50,50,Direct
3489481,275,75,60,140,80,60,60,Direct
3489528,375,150,50,375,325,50,50,Direct
3489762,175,5,20,160,140,20,20,Direct
3490332,350,90,35,175,140,35,35,Direct
3490783,200,30,25,85,60,25,25,Direct
3485801,200,30,35,165,130,35,35,Direct
3483580,75,0,35,190,155,35,35,Direct
3491234,225,60,50,355,305,50,50,Direct
3491268,200,30,50,205,155,50,50,Direct
3491370,225,15,35,185,150,35,35,Direct
3491485,175,20,35,200,165,35,35,Direct
3491570,225,45,35,295,260,35,35,Direct
3491587,150,0,50,250,200,50,50,Direct
3491400,150,0,35,190,155,35,35,Direct
3491770,150,0,50,205,155,50,50,Direct
3491970,350,135,50,200,150,50,50,Direct
3492038,75,0,35,140,105,35,35,Direct
3492136,150,0,25,55,30,25,25,Direct
3492404,100,0,35,105,70,35,35,Direct
3492472,100,0,25,95,70,25,25,Direct
3492506,150,5,50,250,200,50,50,Direct
3492553,250,60,75,320,245,75,75,Direct
3492706,200,15,50,285,235,50,50,Direct
3492740,75,0,25,75,50,25,25,Direct
3492889,125,0,20,140,120,20,20,Direct
3492991,75,0,35,145,110,35,35,Direct
3493323,225,60,50,225,175,50,50,Direct
3493591,50,0,35,180,145,35,35,Direct
3493876,125,0,35,155,120,35,35,Direct
3493859,325,90,35,170,135,35,35,Direct
3493893,225,30,50,265,215,50,50,Direct
3493910,125,0,20,160,140,20,20,Direct
3493991,25,0,35,250,215,35,35,Direct
3491149,225,40,35,150,115,35,35,Direct
3494327,100,0,35,170,135,35,35,Direct
3494710,200,15,50,325,275,50,50,Direct
3494795,175,0,35,155,120,35,35,Direct
3495110,150,5,35,180,145,35,35,Direct
3495093,175,10,35,140,105,35,35,Direct
3495161,225,30,50,260,210,50,50,Direct
3495280,200,30,35,245,210,35,35,Direct
3495331,100,0,21,81,60,21,21,Direct
3495480,75,0,35,150,115,35,35,Direct
3490634,75,0,35,125,90,35,35,Direct
3495629,100,0,20,140,120,20,20,Direct
3495782,75,0,35,135,100,35,35,Direct
3495846,300,100,50,240,190,50,50,Direct
3495880,125,0,20,70,50,20,20,Direct
3496399,200,30,20,170,150,20,20,Direct
3496514,250,65,20,150,130,20,20,Direct
3496952,175,10,50,200,150,50,50,Direct
3496965,250,55,35,265,230,35,35,Direct
3496467,275,45,35,245,210,35,35,Direct
3497186,100,0,60,190,130,60,60,Direct
3497250,175,5,60,160,100,60,60,Direct
3477427,175,5,25,70,45,25,25,Direct
3477602,200,20,35,175,140,35,35,Direct
3460779,175,5,25,55,30,25,25,Direct
3477959,300,70,50,235,185,50,50,Direct
3478134,200,35,50,265,215,50,50,Direct
3478352,350,135,50,285,235,50,50,Direct
3478756,200,5,50,230,180,50,50,Direct
3478938,325,95,35,150,115,35,35,Direct
3479031,275,70,50,280,230,50,50,Direct
3463855,250,60,20,150,130,20,20,Direct
3479224,450,165,50,300,250,50,50,Direct
3479313,100,0,50,375,325,50,50,Direct
3479363,325,120,40,410,370,40,40,Direct
3479424,275,55,35,140,105,35,35,Direct
3479449,425,115,50,370,320,50,50,Direct
3479631,125,0,35,125,90,35,35,Direct
3479831,225,45,50,265,215,50,50,Direct
3479967,125,0,40,275,235,40,40,Direct
3480099,150,0,35,115,80,35,35,Direct
3480249,75,0,50,230,180,50,50,Direct
3480435,175,15,20,135,115,20,20,Direct
3479249,100,0,35,180,145,35,35,Direct
3480717,100,0,20,175,155,20,20,Direct
3480878,175,15,50,325,275,50,50,Direct
3481496,75,0,35,170,135,35,35,Direct
3481721,200,20,50,205,155,50,50,Direct
3481764,300,115,35,260,225,35,35,Direct
3482053,200,35,35,180,145,35,35,Direct
3482346,125,0,35,140,105,35,35,Direct
3482521,300,70,50,210,160,50,50,Direct
3482700,250,70,35,260,225,35,35,Direct
3465584,225,25,25,95,70,25,25,Direct
3483243,175,0,60,110,50,60,60,Direct
3483418,250,65,35,220,185,35,35,Direct
3483593,275,75,35,125,90,35,35,Direct
3483661,125,0,35,240,205,35,35,Direct
3483775,100,0,50,200,150,50,50,Direct
3483950,250,40,35,275,240,35,35,Direct
3484443,150,0,35,105,70,35,35,Direct
3481478,125,0,20,180,160,20,20,Direct
3484647,175,20,35,170,135,35,35,Direct
3484836,50,0,20,30,10,20,20,Direct
3484861,100,0,35,170,135,35,35,Direct
3484904,75,0,35,125,90,35,35,Direct
3485247,175,15,35,170,135,35,35,Direct
3485222,375,150,40,260,220,40,40,Direct
3485440,50,0,35,140,105,35,35,Direct
3485622,225,40,35,150,115,35,35,Direct
3485708,275,85,35,135,100,35,35,Direct
3485758,275,65,20,165,145,20,20,Direct
3476818,175,10,50,215,165,50,50,Direct
3477153,100,0,35,145,110,35,35,Direct
3477354,100,0,20,140,120,20,20,Direct
3477454,125,0,35,110,75,35,35,Direct
3477790,225,35,35,170,135,35,35,Direct
3478240,175,5,50,275,225,50,50,Direct
3478390,375,135,50,235,185,50,50,Direct
3478625,550,290,55,410,355,55,55,Direct
3478675,175,15,25,75,50,25,25,Direct
3478740,275,70,35,175,140,35,35,Direct
3478961,175,10,35,265,230,35,35,Direct
3479076,175,5,35,190,155,35,35,Direct
3479226,50,0,35,160,125,35,35,Direct
3479326,150,0,35,185,150,35,35,Direct
3479362,150,0,50,235,185,50,50,Direct
3479375,200,15,50,210,160,50,50,Direct
3479526,225,45,35,140,105,35,35,Direct
3474582,200,30,35,150,115,35,35,Direct
3479626,250,65,50,230,180,50,50,Direct
3479726,125,0,50,375,325,50,50,Direct
3479776,300,85,50,275,225,50,50,Direct
3480061,175,15,25,85,60,25,25,Direct
3480097,50,0,50,325,275,50,50,Direct
3480147,300,105,100,230,130,100,100,Direct
3480462,200,20,35,145,110,35,35,Direct
3480547,125,0,35,155,120,35,35,Direct
3480598,200,55,20,90,70,20,20,Direct
3481197,375,115,100,265,165,100,100,Direct
3481248,150,0,50,275,225,50,50,Direct
3481484,225,45,15,70,55,15,15,Direct
3481533,175,20,50,265,215,50,50,Direct
3481684,200,25,50,235,185,50,50,Direct
3481783,175,15,50,230,180,50,50,Direct
3481969,100,0,35,220,185,35,35,Direct
3482219,200,25,35,190,155,35,35,Direct
3482234,75,0,20,75,55,20,20,Direct
3482419,175,20,20,140,120,20,20,Direct
3482434,175,10,35,290,255,35,35,Direct
3482870,275,80,35,170,135,35,35,Direct
3481734,275,75,20,170,150,20,20,Direct
3483269,50,0,35,165,130,35,35,Direct
3483306,225,45,35,190,155,35,35,Direct
3483505,425,145,20,170,150,20,20,Direct
3483620,200,20,20,170,150,20,20,Direct
3483655,225,35,20,130,110,20,20,Direct
3483656,125,0,35,110,75,35,35,Direct
3484041,200,30,35,150,115,35,35,Direct
3484156,25,0,35,140,105,35,35,Direct
3484192,50,0,50,200,150,50,50,Direct
3484291,200,30,35,150,115,35,35,Direct
3484342,75,0,25,75,50,25,25,Direct
3484406,100,0,35,170,135,35,35,Direct
3497570,225,45,35,225,190,35,35,Direct
3497650,275,60,40,255,215,40,40,Direct
3497701,175,5,25,70,45,25,25,Direct
3497986,300,70,35,125,90,35,35,Direct
3498054,100,0,40,270,230,40,40,Direct
3498288,175,5,35,145,110,35,35,Direct
3498369,425,120,35,165,130,35,35,Direct
3494144,250,45,50,250,200,50,50,Direct
3498671,325,115,60,180,120,60,60,Direct
3498773,400,145,125,500,375,125,125,Direct
3498922,200,20,20,160,140,20,20,Direct
3499041,100,0,20,140,120,20,20,Direct
3499373,150,0,50,210,160,50,50,Direct
3499424,250,45,50,325,275,50,50,Direct
3499492,200,20,35,160,125,35,35,Direct
3499539,150,5,35,145,110,35,35,Direct
3499658,150,0,35,290,255,35,35,Direct
3499756,75,0,20,80,60,20,20,Direct
3482159,250,60,20,125,105,20,20,Direct
3474990,175,15,35,150,115,35,35,Direct
3500075,175,15,35,180,145,35,35,Direct
3500194,200,35,20,105,85,20,20,Direct
3500224,150,0,35,195,160,35,35,Direct
3500577,175,15,35,190,155,35,35,Direct
3496382,75,0,35,250,215,35,35,Direct
3500611,125,0,50,200,150,50,50,Direct
3500692,150,0,35,155,120,35,35,Direct
3501513,100,0,35,130,95,35,35,Direct
3501679,50,0,20,80,60,20,20,Direct
3501764,200,30,50,275,225,50,50,Direct
3501879,425,145,35,240,205,35,35,Direct
3501862,300,85,35,155,120,35,35,Direct
3502500,200,30,20,140,120,20,20,Direct
3502547,125,0,35,160,125,35,35,Direct
3502598,75,0,25,70,45,25,25,Direct
3502751,275,55,35,125,90,35,35,Direct
3502934,200,10,35,150,115,35,35,Direct
3503100,100,0,35,155,120,35,35,Direct
3503317,250,45,35,150,115,35,35,Direct
3503568,175,10,35,125,90,35,35,Direct
3501496,375,140,35,250,215,35,35,Direct
3501845,150,0,25,85,60,25,25,Direct
3503785,350,115,35,160,125,35,35,Direct
3504121,150,5,20,140,120,20,20,Direct
3504155,200,10,20,80,60,20,20,Direct
3504219,225,35,35,155,120,35,35,Direct
3504402,125,0,35,155,120,35,35,Direct
3504419,200,20,50,225,175,50,50,Direct
3504555,250,65,20,130,110,20,20,Direct
3504572,175,0,35,225,190,35,35,Direct
3504687,225,35,35,245,210,35,35,Direct
3486383,150,0,40,230,190,40,40,Direct
3486440,150,0,35,155,120,35,35,Direct
3486576,100,0,35,230,195,35,35,Direct
3457321,150,0,35,170,135,35,35,Direct
3486758,175,5,35,145,110,35,35,Direct
3486894,175,15,20,175,155,20,20,Direct
3486987,525,245,75,345,270,75,75,Direct
3487001,500,220,50,275,225,50,50,Direct
3487137,275,60,35,165,130,35,35,Direct
3487187,125,0,35,225,190,35,35,Direct
3487226,275,60,20,160,140,20,20,Direct
3487251,450,190,35,240,205,35,35,Direct
3487387,550,205,75,315,240,75,75,Direct
3487455,225,75,35,150,115,35,35,Direct
3487937,225,60,35,220,185,35,35,Direct
3488380,225,25,50,265,215,50,50,Direct
3488455,175,0,50,260,210,50,50,Direct
3488498,375,155,35,260,225,35,35,Direct
3488591,250,65,40,375,335,40,40,Direct
3488716,750,430,370,910,540,370,370,Direct
3489073,375,115,60,185,125,60,60,Direct
3489384,175,15,50,325,275,50,50,Direct
3489609,125,0,50,205,155,50,50,Direct
3489634,200,20,50,240,190,50,50,Direct
3490077,125,0,20,160,140,20,20,Direct
3490170,100,0,75,300,225,75,75,Direct
3490259,175,10,35,275,240,35,35,Direct
3490545,200,30,35,170,135,35,35,Direct
3490856,250,50,50,270,220,50,50,Direct
3486251,300,100,35,175,140,35,35,Direct
3491038,100,0,35,170,135,35,35,Direct
3491063,125,0,20,75,55,20,20,Direct
3491263,350,120,35,185,150,35,35,Direct
3491456,350,115,50,375,325,50,50,Direct
3491481,75,0,20,195,175,20,20,Direct
3491506,50,0,35,180,145,35,35,Direct
3491549,225,35,50,230,180,50,50,Direct
3491731,175,15,20,80,60,20,20,Direct
3491817,250,65,20,140,120,20,20,Direct
3492199,75,0,35,135,100,35,35,Direct
3492174,0,0,20,165,145,20,20,Direct
3492335,225,30,50,250,200,50,50,Direct
3492399,125,0,50,250,200,50,50,Direct
3492460,100,0,35,110,75,35,35,Direct
3480810,125,0,50,245,195,50,50,Direct
3492749,175,15,45,125,80,45,45,Direct
3492910,225,15,50,375,325,50,50,Direct
3493042,125,0,25,90,65,25,25,Direct
3493242,150,0,20,40,20,20,20,Direct
3493485,100,0,35,170,135,35,35,Direct
3493578,250,45,35,180,145,35,35,Direct
3493646,225,45,35,130,95,35,35,Direct
3493670,125,0,20,75,55,20,20,Direct
3493728,50,0,50,205,155,50,50,Direct
3493739,150,5,35,170,135,35,35,Direct
3493914,175,5,35,125,90,35,35,Direct
3493996,100,0,20,45,25,20,20,Direct
3494289,175,15,37,162,125,37,37,Direct
3470596,250,65,35,175,140,35,35,Direct
3486757,300,75,50,260,210,50,50,Direct
3486857,200,20,50,270,220,50,50,Direct
3486991,250,50,50,260,210,50,50,Direct
3487021,250,25,20,150,130,20,20,Direct
3487057,225,40,35,170,135,35,35,Direct
3487072,350,105,50,240,190,50,50,Direct
3487208,250,55,50,240,190,50,50,Direct
3485955,100,0,25,80,55,25,25,Direct
3487542,300,85,50,325,275,50,50,Direct
3487608,125,0,25,90,65,25,25,Direct
3487706,25,0,50,210,160,50,50,Direct
3424668,425,200,50,275,225,50,50,Direct
3488291,200,20,35,180,145,35,35,Direct
3488544,175,10,20,145,125,20,20,Direct
3489080,125,0,35,150,115,35,35,Direct
3489129,75,0,20,140,120,20,20,Direct
3489314,175,0,20,95,75,20,20,Direct
3489329,225,50,20,180,160,20,20,Direct
3489578,100,0,35,150,115,35,35,Direct
3489580,75,0,50,250,200,50,50,Direct
3489680,250,45,50,220,170,50,50,Direct
3489780,200,25,50,220,170,50,50,Direct
3489814,150,0,20,140,120,20,20,Direct
3489865,225,45,35,180,145,35,35,Direct
3489899,150,0,35,150,115,35,35,Direct
3490199,175,15,35,145,110,35,35,Direct
3490501,25,0,35,160,125,35,35,Direct
3486972,250,40,50,220,170,50,50,Direct
3482728,450,145,50,280,230,50,50,Direct
3491050,175,5,35,150,115,35,35,Direct
3491201,175,20,50,385,335,50,50,Direct
3491450,175,5,50,155,105,50,50,Direct
3491537,75,0,20,75,55,20,20,Direct
3491586,50,0,35,225,190,35,35,Direct
3491771,125,0,20,75,55,20,20,Direct
3492088,225,25,35,155,120,35,35,Direct
3492188,250,65,50,260,210,50,50,Direct
3492071,175,5,25,90,65,25,25,Direct
3492237,125,0,50,215,165,50,50,Direct
3491971,100,0,35,140,105,35,35,Direct
3477631,225,35,35,125,90,35,35,Direct
3492586,200,20,50,210,160,50,50,Direct
3492707,175,20,33,123,90,33,33,Direct
3493273,325,90,50,250,200,50,50,Direct
3493573,125,0,20,140,120,20,20,Direct
3493522,100,0,50,230,180,50,50,Direct
3449938,225,45,25,80,55,25,25,Direct
3493858,150,0,50,245,195,50,50,Direct
3493860,175,0,20,75,55,20,20,Direct
3464549,150,0,25,95,70,25,25,Direct
3465124,175,0,35,150,115,35,35,Direct
3465358,75,0,35,190,155,35,35,Direct
3465753,125,0,20,160,140,20,20,Direct
3465728,125,0,35,100,65,35,35,Direct
3465787,300,20,20,190,170,20,20,Direct
3466153,100,0,20,140,120,20,20,Direct
3466255,175,0,35,125,90,35,35,Direct
3466430,325,40,25,80,55,25,25,Direct
3451615,100,0,35,125,90,35,35,Direct
3466621,225,0,50,325,275,50,50,Direct
3466889,175,0,35,150,115,35,35,Direct
3466962,175,0,50,245,195,50,50,Direct
3467030,175,0,35,150,115,35,35,Direct
3467289,575,255,110,460,350,110,110,Direct
3467489,300,20,35,150,115,35,35,Direct
3467498,125,0,35,185,150,35,35,Direct
3467532,175,0,50,255,205,50,50,Direct
3388373,125,0,20,195,175,20,20,Direct
3467723,350,70,50,250,200,50,50,Direct
3468000,125,0,35,175,140,35,35,Direct
3468034,100,0,35,250,215,35,35,Direct
3468132,100,0,50,200,150,50,50,Direct
3468259,125,0,35,110,75,35,35,Direct
3468893,200,0,50,220,170,50,50,Direct
3468868,175,0,25,85,60,25,25,Direct
3468995,225,0,50,250,200,50,50,Direct
3469004,100,0,35,270,235,35,35,Direct
3469102,450,145,50,215,165,50,50,Direct
3469068,125,0,35,185,150,35,35,Direct
3469204,300,20,35,190,155,35,35,Direct
3469370,225,0,20,170,150,20,20,Direct
3469663,200,0,35,150,115,35,35,Direct
3469697,275,0,50,250,200,50,50,Direct
3469999,75,0,20,170,150,20,20,Direct
3470097,150,0,35,255,220,35,35,Direct
3470433,275,0,20,40,20,20,20,Direct
3470497,300,85,110,405,295,110,110,Direct
3470999,125,0,35,195,160,35,35,Direct
3471076,200,0,25,95,70,25,25,Direct
3471267,75,0,50,250,200,50,50,Direct
3471344,225,35,50,205,155,50,50,Direct
3471901,200,25,50,255,205,50,50,Direct
3471910,200,35,35,160,125,35,35,Direct
3471944,250,55,50,210,160,50,50,Direct
3472037,175,10,25,75,50,25,25,Direct
3471969,250,55,20,160,140,20,20,Direct
3472046,125,0,50,255,205,50,50,Direct
3472101,250,50,35,265,230,35,35,Direct
3472310,200,30,50,275,225,50,50,Direct
3494732,100,0,50,230,180,50,50,Direct
3494807,175,10,20,175,155,20,20,Direct
3494875,225,45,60,195,135,60,60,Direct
3495064,200,25,20,85,65,20,20,Direct
3495250,225,55,20,85,65,20,20,Direct
3495343,350,125,36,196,160,36,36,Direct
3492535,200,30,35,175,140,35,35,Direct
3495761,200,15,50,205,155,50,50,Direct
3496050,175,10,35,190,155,35,35,Direct
3496229,175,15,24,64,40,24,24,Direct
3496161,300,95,20,125,105,20,20,Direct
3496404,75,0,35,160,125,35,35,Direct
3496747,100,0,20,75,55,20,20,Direct
3496879,175,20,20,180,160,20,20,Direct
3496961,200,25,35,170,135,35,35,Direct
3497079,50,0,50,210,160,50,50,Direct
3497072,175,10,50,345,295,50,50,Direct
3497279,125,0,50,230,180,50,50,Direct
3497390,200,20,25,75,50,25,25,Direct
3497683,225,45,37,152,115,37,37,Direct
3497940,75,0,20,130,110,20,20,Direct
3498083,100,0,20,160,140,20,20,Direct
3498565,75,0,35,125,90,35,35,Direct
3498619,125,0,20,170,150,20,20,Direct
3499076,125,0,20,160,140,20,20,Direct
3499262,100,0,20,115,95,20,20,Direct
3499351,150,0,20,140,120,20,20,Direct
3499419,25,0,35,225,190,35,35,Direct
3497722,200,15,35,115,80,35,35,Direct
3488180,225,45,50,295,245,50,50,Direct
3470464,50,0,20,75,55,20,20,Direct
3499944,200,35,35,120,85,35,35,Direct
3499969,275,80,50,215,165,50,50,Direct
3500262,175,10,20,140,120,20,20,Direct
3497254,200,35,20,120,100,20,20,Direct
3500398,175,10,20,75,55,20,20,Direct
3500487,425,120,35,210,175,35,35,Direct
3500680,200,30,35,115,80,35,35,Direct
3500705,225,45,50,275,225,50,50,Direct
3501466,150,0,35,165,130,35,35,Direct
3501891,125,0,20,75,55,20,20,Direct
3502095,150,5,60,150,90,60,60,Direct
3502177,200,15,60,105,45,60,60,Direct
3502270,150,0,50,275,225,50,50,Direct
3502352,200,35,35,150,115,35,35,Direct
3502420,200,25,50,200,150,50,50,Direct
3502752,100,0,50,295,245,50,50,Direct
3502763,200,15,35,210,175,35,35,Direct
3494094,200,5,20,160,140,20,20,Direct
3494194,175,10,50,280,230,50,50,Direct
3494209,200,30,35,170,135,35,35,Direct
3494258,100,0,35,145,110,35,35,Direct
3494358,175,10,35,245,210,35,35,Direct
3494509,100,0,40,220,180,40,40,Direct
3494494,100,0,35,160,125,35,35,Direct
3494645,225,15,35,150,115,35,35,Direct
3494794,50,0,35,160,125,35,35,Direct
3495143,300,70,50,235,185,50,50,Direct
3495194,175,5,35,135,100,35,35,Direct
3495330,200,20,20,160,140,20,20,Direct
3495596,75,0,35,170,135,35,35,Direct
3481977,50,0,35,125,90,35,35,Direct
3495630,125,0,35,145,110,35,35,Direct
3486455,250,65,35,180,145,35,35,Direct
3463408,100,0,35,160,125,35,35,Direct
3495779,175,10,20,180,160,20,20,Direct
3495781,200,20,40,255,215,40,40,Direct
3450923,200,25,35,105,70,35,35,Direct
3496115,275,75,35,190,155,35,35,Direct
3495681,150,0,50,325,275,50,50,Direct
3496317,400,145,50,205,155,50,50,Direct
3496466,300,100,50,275,225,50,50,Direct
3496866,100,0,35,190,155,35,35,Direct
3497015,75,0,20,75,55,20,20,Direct
3497117,175,10,35,190,155,35,35,Direct
3497166,175,5,25,50,25,25,25,Direct
3497353,175,5,35,155,120,35,35,Direct
3497402,400,210,50,285,235,50,50,Direct
3497553,50,0,50,235,185,50,50,Direct
3497551,325,120,35,165,130,35,35,Direct
3497587,125,0,50,215,165,50,50,Direct
3497687,200,35,20,65,45,20,20,Direct
3497868,200,20,35,175,140,35,35,Direct
3497902,225,45,40,235,195,40,40,Direct
3498438,75,0,20,80,60,20,20,Direct
3498840,125,0,35,170,135,35,35,Direct
3499023,50,0,35,130,95,35,35,Direct
3499140,200,30,20,150,130,20,20,Direct
3499138,425,115,35,130,95,35,35,Direct
3499240,300,85,50,275,225,50,50,Direct
3499659,375,140,50,210,160,50,50,Direct
3486121,100,0,35,150,115,35,35,Direct
3474387,50,0,35,160,125,35,35,Direct
3501110,150,0,25,75,50,25,25,Direct
3501261,175,10,35,135,100,35,35,Direct
3501546,175,10,35,150,115,35,35,Direct
3501782,225,30,35,190,155,35,35,Direct
3501831,100,0,35,155,120,35,35,Direct
3501948,175,10,35,175,140,35,35,Direct
3502082,100,0,35,185,150,35,35,Direct
3502131,325,85,35,155,120,35,35,Direct
3502497,325,120,50,275,225,50,50,Direct
3502533,200,25,50,285,235,50,50,Direct
3502633,200,20,50,320,270,50,50,Direct
3502784,175,15,35,175,140,35,35,Direct
3461398,150,0,33,138,105,33,33,Direct
3461591,100,0,35,120,85,35,35,Direct
3461557,75,0,50,220,170,50,50,Direct
3462034,225,0,25,80,55,25,25,Direct
3449330,100,0,35,150,115,35,35,Direct
3462829,225,15,35,245,210,35,35,Direct
3462834,100,0,50,240,190,50,50,Direct
3462970,75,0,35,125,90,35,35,Direct
3463172,100,0,35,155,120,35,35,Direct
3463363,75,0,20,170,150,20,20,Direct
3463629,125,0,25,50,25,25,25,Direct
3463770,100,0,35,155,120,35,35,Direct
3464265,175,0,35,160,125,35,35,Direct
3464408,125,0,60,145,85,60,60,Direct
3464806,300,0,35,180,145,35,35,Direct
3461691,350,40,35,125,90,35,35,Direct
3465035,300,85,100,215,115,100,100,Direct
3465235,175,0,35,135,100,35,35,Direct
3465442,75,0,50,200,150,50,50,Direct
3465542,125,0,35,155,120,35,35,Direct
3466080,100,0,20,140,120,20,20,Direct
3458590,75,0,35,150,115,35,35,Direct
3457954,275,65,35,190,155,35,35,Direct
3466671,125,0,25,75,50,25,25,Direct
3466937,125,0,35,155,120,35,35,Direct
3455741,50,0,60,195,135,60,60,Direct
3467614,300,0,50,235,185,50,50,Direct
3467673,225,0,35,170,135,35,35,Direct
3467773,200,0,35,190,155,35,35,Direct
3467907,150,0,20,95,75,20,20,Direct
3467973,175,0,60,175,115,60,60,Direct
3468150,200,0,50,255,205,50,50,Direct
3468745,325,20,50,200,150,50,50,Direct
3469145,175,0,35,190,155,35,35,Direct
3429169,250,0,35,125,90,35,35,Direct
3469043,100,0,20,30,10,20,20,Direct
3469722,250,0,20,195,175,20,20,Direct
3468386,100,0,35,190,155,35,35,Direct
3470224,325,20,35,155,120,35,35,Direct
3470315,325,15,20,160,140,20,20,Direct
3470381,150,0,35,195,160,35,35,Direct
3470617,175,0,35,190,155,35,35,Direct
3470658,800,430,340,885,545,340,340,Direct
3470622,300,0,35,190,155,35,35,Direct
3470751,100,0,20,65,45,20,20,Direct
3458190,225,0,35,170,135,35,35,Direct
3479852,275,65,35,125,90,35,35,Direct
3480388,75,0,20,160,140,20,20,Direct
3480607,275,65,35,195,160,35,35,Direct
3480671,225,35,35,195,160,35,35,Direct
3481107,400,160,75,330,255,75,75,Direct
3481524,225,80,60,165,105,60,60,Direct
3481943,275,65,35,160,125,35,35,Direct
3482124,225,40,35,225,190,35,35,Direct
3482258,200,25,75,395,320,75,75,Direct
3482309,225,45,35,290,255,35,35,Direct
3481909,25,0,35,135,100,35,35,Direct
3482409,200,30,35,160,125,35,35,Direct
3482494,350,100,50,200,150,50,50,Direct
3482509,100,0,50,210,160,50,50,Direct
3479886,225,30,50,275,225,50,50,Direct
3471513,200,20,35,150,115,35,35,Direct
3483196,250,65,50,260,210,50,50,Direct
3483281,50,0,20,110,90,20,20,Direct
3483245,300,75,75,385,310,75,75,Direct
3483430,225,40,35,185,150,35,35,Direct
3483732,175,10,50,200,150,50,50,Direct
3483915,275,85,50,275,225,50,50,Direct
3484481,250,45,90,200,110,90,90,Direct
3484581,200,10,35,155,120,35,35,Direct
3484617,250,70,35,165,130,35,35,Direct
3484668,275,80,50,275,225,50,50,Direct
3485102,275,60,36,151,115,36,36,Direct
3485168,175,10,35,155,120,35,35,Direct
3469777,175,10,20,95,75,20,20,Direct
3485702,175,10,35,185,150,35,35,Direct
3485753,100,0,50,205,155,50,50,Direct
3485804,75,0,35,125,90,35,35,Direct
3486004,150,0,25,55,30,25,25,Direct
3486053,125,0,35,180,145,35,35,Direct
3486489,175,10,20,115,95,20,20,Direct
3486538,200,30,20,95,75,20,20,Direct
3486789,200,15,35,150,115,35,35,Direct
3486940,100,0,50,230,180,50,50,Direct
3486989,150,0,50,210,160,50,50,Direct
3429714,175,10,35,155,120,35,35,Direct
3487038,150,0,35,125,90,35,35,Direct
3487325,125,0,35,180,145,35,35,Direct
3487423,225,45,25,95,70,25,25,Direct
3487540,225,35,35,240,205,35,35,Direct
3487559,175,15,25,75,50,25,25,Direct
3487625,100,0,35,130,95,35,35,Direct
3487759,325,90,35,180,145,35,35,Direct
3487974,100,0,35,175,140,35,35,Direct
3488225,175,10,20,140,120,20,20,Direct
3488259,200,20,20,140,120,20,20,Direct
3502977,50,0,50,225,175,50,50,Direct
3503070,175,15,35,170,135,35,35,Direct
3503295,100,0,50,205,155,50,50,Direct
3503431,125,0,35,180,145,35,35,Direct
3503888,100,0,35,150,115,35,35,Direct
3504117,175,10,20,170,150,20,20,Direct
3504231,200,20,20,160,140,20,20,Direct
3504167,175,5,35,170,135,35,35,Direct
3504499,125,0,35,150,115,35,35,Direct
3504517,175,15,50,275,225,50,50,Direct
3504699,100,0,20,95,75,20,20,Direct
3504717,175,10,35,155,120,35,35,Direct
3504767,150,0,35,170,135,35,35,Direct
3504824,300,110,35,175,140,35,35,Direct
3504849,100,0,35,180,145,35,35,Direct
3505092,500,190,75,310,235,75,75,Direct
3505453,250,50,35,245,210,35,35,Direct
3505678,175,10,35,155,120,35,35,Direct
3505746,150,0,35,160,125,35,35,Direct
3505896,250,50,50,265,215,50,50,Direct
3506078,200,20,50,215,165,50,50,Direct
3506253,200,10,20,80,60,20,20,Direct
3506682,175,0,50,275,225,50,50,Direct
3495157,0,0,20,175,155,20,20,Direct
3495275,175,15,35,250,215,35,35,Direct
3507682,200,40,50,200,150,50,50,Direct
3507700,300,75,35,185,150,35,35,Direct
3507793,50,0,35,130,95,35,35,Direct
3507832,275,85,35,170,135,35,35,Direct
3507911,225,40,35,250,215,35,35,Direct
3508261,200,30,50,235,185,50,50,Direct
3509022,100,0,35,100,65,35,35,Direct
3509172,250,55,35,150,115,35,35,Direct
3509197,125,0,35,165,130,35,35,Direct
3500555,200,25,75,365,290,75,75,Direct
3509529,175,0,25,80,55,25,25,Direct
3509758,175,15,50,260,210,50,50,Direct
3509890,325,105,55,300,245,55,55,Direct
3506482,225,35,40,275,235,40,40,Direct
3509997,150,0,60,195,135,60,60,Direct
3510065,300,85,50,250,200,50,50,Direct
3510222,175,10,50,215,165,50,50,Direct
3510465,425,120,60,185,125,60,60,Direct
3510851,25,0,35,155,120,35,35,Direct
3510758,350,125,110,405,295,110,110,Direct
3509311,50,0,20,140,120,20,20,Direct
3483186,375,150,50,235,185,50,50,Direct
3483339,225,45,35,150,115,35,35,Direct
3483421,275,60,35,145,110,35,35,Direct
3483472,100,0,50,165,115,50,50,Direct
3483471,75,0,35,140,105,35,35,Direct
3484071,325,105,50,230,180,50,50,Direct
3484275,200,30,50,230,180,50,50,Direct
3484390,100,0,36,146,110,36,36,Direct
3399172,125,0,35,170,135,35,35,Direct
3484926,75,0,35,215,180,35,35,Direct
3485025,175,15,50,230,180,50,50,Direct
3485479,125,0,35,160,125,35,35,Direct
3485543,200,15,35,260,225,35,35,Direct
3485743,400,150,20,180,160,20,20,Direct
3485812,125,0,50,205,155,50,50,Direct
3486147,200,25,100,250,150,100,100,Direct
3486548,200,35,35,180,145,35,35,Direct
3486829,75,0,35,180,145,35,35,Direct
3487266,200,25,35,100,65,35,35,Direct
3487334,75,0,50,230,180,50,50,Direct
3487548,200,35,20,175,155,20,20,Direct
3487551,275,75,35,150,115,35,35,Direct
3487748,225,30,35,250,215,35,35,Direct
3488083,125,0,20,140,120,20,20,Direct
3488152,150,0,35,220,185,35,35,Direct
3488233,175,15,50,225,175,50,50,Direct
3488534,125,0,35,150,115,35,35,Direct
3488687,200,10,35,180,145,35,35,Direct
3468581,225,25,35,170,135,35,35,Direct
3489355,200,25,35,140,105,35,35,Direct
3489623,125,0,35,140,105,35,35,Direct
3488369,125,0,20,95,75,20,20,Direct
3490023,175,10,25,65,40,25,25,Direct
3490024,75,0,35,225,190,35,35,Direct
3490156,125,0,35,190,155,35,35,Direct
3490241,150,0,60,100,40,60,60,Direct
3490356,150,5,50,250,200,50,50,Direct
3490423,75,0,20,35,15,20,20,Direct
3490509,75,0,50,200,150,50,50,Direct
3490606,525,270,50,350,300,50,50,Direct
3482986,75,0,35,125,90,35,35,Direct
3491041,200,25,50,230,180,50,50,Direct
3491177,125,0,20,180,160,20,20,Direct
3491228,25,0,25,65,40,25,25,Direct
3491241,325,90,60,175,115,60,60,Direct
3491291,425,120,35,180,145,35,35,Direct
3491509,100,0,20,160,140,20,20,Direct
3491577,225,40,35,175,140,35,35,Direct
3486833,250,45,35,165,130,35,35,Direct
3486951,175,5,20,175,155,20,20,Direct
3487144,100,0,50,320,270,50,50,Direct
3487555,150,0,35,145,110,35,35,Direct
3488398,25,0,35,285,250,35,35,Direct
3488616,150,5,35,195,160,35,35,Direct
3488680,250,60,20,150,130,20,20,Direct
3488891,150,0,35,250,215,35,35,Direct
3483093,125,0,35,285,250,35,35,Direct
3489845,200,10,50,275,225,50,50,Direct
3489934,25,0,35,100,65,35,35,Direct
3490245,250,50,35,225,190,35,35,Direct
3490352,175,15,50,250,200,50,50,Direct
3490363,150,0,35,225,190,35,35,Direct
3490427,150,5,50,220,170,50,50,Direct
3490552,75,0,20,80,60,20,20,Direct
3490577,75,0,20,85,65,20,20,Direct
3476516,225,40,20,120,100,20,20,Direct
3491006,125,0,50,275,225,50,50,Direct
3491031,150,0,35,145,110,35,35,Direct
3491313,375,100,20,160,140,20,20,Direct
3491295,375,135,35,185,150,35,35,Direct
3491338,175,10,60,105,45,60,60,Direct
3491381,325,100,35,150,115,35,35,Direct
3491424,225,45,35,150,115,35,35,Direct
3491499,75,0,35,225,190,35,35,Direct
3491563,250,60,40,235,195,40,40,Direct
3491763,150,5,20,75,55,20,20,Direct
3491899,100,0,20,190,170,20,20,Direct
3492206,125,0,40,325,285,40,40,Direct
3492785,150,0,50,230,180,50,50,Direct
3475630,375,120,50,325,275,50,50,Direct
3493210,175,0,35,155,120,35,35,Direct
3493253,200,30,35,105,70,35,35,Direct
3493278,75,0,35,125,90,35,35,Direct
3493453,400,150,50,240,190,50,50,Direct
3493610,75,0,35,155,120,35,35,Direct
3493703,225,35,50,255,205,50,50,Direct
3494014,175,10,35,170,135,35,35,Direct
3494321,125,0,35,160,125,35,35,Direct
3495014,175,15,20,65,45,20,20,Direct
3495057,525,215,50,275,225,50,50,Direct
3495300,100,0,20,160,140,20,20,Direct
3502833,175,5,35,160,125,35,35,Direct
3502867,200,15,35,130,95,35,35,Direct
3502918,200,15,35,180,145,35,35,Direct
3502884,200,25,35,145,110,35,35,Direct
3502967,275,60,35,190,155,35,35,Direct
3503048,275,75,50,365,315,50,50,Direct
3503082,175,5,20,90,70,20,20,Direct
3503118,225,45,35,155,120,35,35,Direct
3503169,125,0,50,250,200,50,50,Direct
3503233,325,90,20,160,140,20,20,Direct
3503284,125,0,25,75,50,25,25,Direct
3503269,350,115,75,305,230,75,75,Direct
3503384,75,0,15,70,55,15,15,Direct
3503469,175,10,20,95,75,20,20,Direct
3500910,75,0,35,165,130,35,35,Direct
3500374,125,0,35,140,105,35,35,Direct
3503903,275,55,35,165,130,35,35,Direct
3503920,375,150,50,230,180,50,50,Direct
3504254,300,80,75,300,225,75,75,Direct
3504354,225,30,35,250,215,35,35,Direct
3504439,75,0,25,65,40,25,25,Direct
3504503,425,145,110,490,380,110,110,Direct
3504620,275,85,50,210,160,50,50,Direct
3504856,175,0,50,205,155,50,50,Direct
3505139,350,100,35,145,110,35,35,Direct
3505856,100,0,50,200,150,50,50,Direct
3502467,150,0,25,75,50,25,25,Direct
3506177,175,10,35,135,100,35,35,Direct
3506275,150,5,35,225,190,35,35,Direct
3506375,50,0,25,60,35,25,25,Direct
3506541,200,30,35,180,145,35,35,Direct
3506592,175,15,50,225,175,50,50,Direct
3506692,200,25,35,150,115,35,35,Direct
3506828,225,30,35,155,120,35,35,Direct
3506877,225,45,20,160,140,20,20,Direct
3507128,225,25,35,230,195,35,35,Direct
3507313,250,55,35,145,110,35,35,Direct
3505505,175,15,35,175,140,35,35,Direct
3499974,125,0,20,120,100,20,20,Direct
3507711,100,0,35,100,65,35,35,Direct
3508049,275,60,20,190,170,20,20,Direct
3508047,225,40,50,250,200,50,50,Direct
3508283,275,75,35,160,125,35,35,Direct
3508464,200,20,35,225,190,35,35,Direct
3508549,200,25,35,205,170,35,35,Direct
3508583,225,45,35,155,120,35,35,Direct
3508600,175,20,35,175,140,35,35,Direct
3508647,100,0,50,230,180,50,50,Direct
3508734,275,75,50,250,200,50,50,Direct
3508949,200,25,35,190,155,35,35,Direct
3509085,375,150,50,260,210,50,50,Direct
3509219,175,15,50,275,225,50,50,Direct
3509383,125,0,20,155,135,20,20,Direct
3509536,150,0,45,150,105,45,45,Direct
3509800,200,15,50,250,200,50,50,Direct
3505739,275,55,20,170,150,20,20,Direct
3509934,350,105,35,150,115,35,35,Direct
3510085,75,0,50,210,160,50,50,Direct
3475388,475,190,75,325,250,75,75,Direct
3475486,400,140,50,340,290,50,50,Direct
3475856,225,30,20,170,150,20,20,Direct
3475779,250,50,110,440,330,110,110,Direct
3476213,350,135,35,250,215,35,35,Direct
3476222,225,30,20,95,75,20,20,Direct
3476256,125,0,35,150,115,35,35,Direct
3476324,250,60,35,100,65,35,35,Direct
3476388,175,10,35,155,120,35,35,Direct
3476422,25,0,35,165,130,35,35,Direct
3476490,200,45,25,80,55,25,25,Direct
3476456,350,125,20,155,135,20,20,Direct
3476524,175,10,35,260,225,35,35,Direct
3476617,175,0,20,130,110,20,20,Direct
3476881,125,0,40,200,160,40,40,Direct
3476992,225,45,20,160,140,20,20,Direct
3477017,175,10,35,100,65,35,35,Direct
3469963,325,130,35,185,150,35,35,Direct
3477528,250,50,60,150,90,60,60,Direct
3477894,125,0,50,220,170,50,50,Direct
3478196,275,65,35,180,145,35,35,Direct
3478255,200,15,35,100,65,35,35,Direct
3478855,100,0,50,210,160,50,50,Direct
3478898,175,10,50,280,230,50,50,Direct
3478923,250,65,50,220,170,50,50,Direct
3479089,25,0,50,225,175,50,50,Direct
3459910,200,30,50,225,175,50,50,Direct
3479323,200,20,50,245,195,50,50,Direct
3479532,175,15,35,180,145,35,35,Direct
3463845,125,0,35,150,115,35,35,Direct
3479664,175,10,40,240,200,40,40,Direct
3480098,100,0,20,80,60,20,20,Direct
3480366,50,0,55,120,65,55,55,Direct
3480459,50,0,35,290,255,35,35,Direct
3480527,150,0,35,250,215,35,35,Direct
3480727,350,150,50,255,205,50,50,Direct
3480736,225,60,50,235,185,50,50,Direct
3481327,175,10,20,195,175,20,20,Direct
3481472,200,20,40,275,235,40,40,Direct
3481604,275,70,35,155,120,35,35,Direct
3482199,200,15,25,75,50,25,25,Direct
3482306,100,0,35,155,120,35,35,Direct
3482497,150,5,35,140,105,35,35,Direct
3482540,125,0,20,140,120,20,20,Direct
3482608,150,0,35,245,210,35,35,Direct
3506588,225,35,50,235,185,50,50,Direct
3506688,250,45,50,250,200,50,50,Direct
3506715,150,0,60,100,40,60,60,Direct
3506815,200,30,35,175,140,35,35,Direct
3507081,200,20,50,250,200,50,50,Direct
3507117,125,0,50,375,325,50,50,Direct
3507124,225,35,50,220,170,50,50,Direct
3507115,400,155,110,415,305,110,110,Direct
3492675,250,65,20,95,75,20,20,Direct
3505143,75,0,35,120,85,35,35,Direct
3507724,175,5,35,150,115,35,35,Direct
3507758,75,0,20,80,60,20,20,Direct
3507917,50,0,35,225,190,35,35,Direct
3507953,125,0,35,150,115,35,35,Direct
3508094,125,0,60,195,135,60,60,Direct
3508153,175,10,20,130,110,20,20,Direct
3508194,100,0,20,160,140,20,20,Direct
3508351,175,5,40,260,220,40,40,Direct
3508560,200,40,35,270,235,35,35,Direct
3508587,175,10,40,310,270,40,40,Direct
3508594,25,0,35,145,110,35,35,Direct
3508653,200,50,50,215,165,50,50,Direct
3508860,100,0,35,270,235,35,35,Direct
3508994,625,345,55,430,375,55,55,Direct
3503571,275,70,35,195,160,35,35,Direct
3509189,200,25,35,150,115,35,35,Direct
3509194,250,45,25,80,55,25,25,Direct
3510266,225,45,35,185,150,35,35,Direct
3510432,250,45,50,265,215,50,50,Direct
3510559,300,75,50,210,160,50,50,Direct
3510623,400,145,75,360,285,75,75,Direct
3510925,175,0,60,145,85,60,60,Direct
3510966,250,55,20,140,120,20,20,Direct
3495490,175,10,35,190,155,35,35,Direct
3511159,50,0,20,160,140,20,20,Direct
3511202,175,25,35,150,115,35,35,Direct
3470983,250,45,35,250,215,35,35,Direct
3511459,425,140,50,390,340,50,50,Direct
3511897,250,55,35,160,125,35,35,Direct
3512102,125,0,25,75,50,25,25,Direct
3512131,250,65,35,285,250,35,35,Direct
3512197,175,15,50,230,180,50,50,Direct
3505752,200,40,50,250,200,50,50,Direct
3512340,75,0,35,170,135,35,35,Direct
3512404,75,0,40,235,195,40,40,Direct
3512504,175,10,35,290,255,35,35,Direct
3512604,200,30,35,120,85,35,35,Direct
3481345,200,20,35,155,120,35,35,Direct
3512731,200,15,50,260,210,50,50,Direct
3512874,200,30,35,155,120,35,35,Direct
3513067,50,0,35,250,215,35,35,Direct
3513374,175,10,20,95,75,20,20,Direct
3513333,275,60,35,180,145,35,35,Direct
3501508,175,15,35,210,175,35,35,Direct
3513740,175,0,35,105,70,35,35,Direct
3513810,175,10,35,165,130,35,35,Direct
3485067,250,55,50,290,240,50,50,Direct
3483714,625,300,110,415,305,110,110,Direct
3485301,250,45,35,130,95,35,35,Direct
3485318,100,0,20,140,120,20,20,Direct
3485369,125,0,40,275,235,40,40,Direct
3485586,200,25,50,245,195,50,50,Direct
3485637,125,0,35,175,140,35,35,Direct
3485905,25,0,35,170,135,35,35,Direct
3486088,475,170,50,270,220,50,50,Direct
3486203,125,0,50,205,155,50,50,Direct
3486637,75,0,35,200,165,35,35,Direct
3481323,175,0,35,155,120,35,35,Direct
3486837,200,35,60,195,135,60,60,Direct
3486854,250,45,35,190,155,35,35,Direct
3486905,125,0,35,145,110,35,35,Direct
3486922,100,0,25,55,30,25,25,Direct
3487024,175,0,35,250,215,35,35,Direct
3487075,200,20,35,195,160,35,35,Direct
3487088,175,15,35,150,115,35,35,Direct
3487241,125,0,35,110,75,35,35,Direct
3487556,100,0,20,75,55,20,20,Direct
3487624,25,0,50,220,170,50,50,Direct
3487743,75,0,35,160,125,35,35,Direct
3487994,200,25,35,135,100,35,35,Direct
3488109,200,25,20,160,140,20,20,Direct
3488211,75,0,50,210,160,50,50,Direct
3488228,75,0,15,70,55,15,15,Direct
3488560,75,0,35,165,130,35,35,Direct
3489296,75,0,50,205,155,50,50,Direct
3489364,175,5,50,325,275,50,50,Direct
3489679,200,20,50,220,170,50,50,Direct
3489696,225,45,50,215,165,50,50,Direct
3489798,125,0,20,170,150,20,20,Direct
3489832,325,90,50,240,190,50,50,Direct
3488024,225,55,35,240,205,35,35,Direct
3490147,125,0,35,135,100,35,35,Direct
3490398,100,0,35,130,95,35,35,Direct
3490564,75,0,20,80,60,20,20,Direct
3490598,250,65,50,240,190,50,50,Direct
3477779,125,0,35,140,105,35,35,Direct
3484297,225,25,35,180,145,35,35,Direct
3489598,75,0,35,155,120,35,35,Direct
3491219,275,60,50,230,180,50,50,Direct
3491317,175,5,34,184,150,34,34,Direct
3491334,150,0,35,150,115,35,35,Direct
3491402,100,0,20,110,90,20,20,Direct
3491283,25,0,35,195,160,35,35,Direct
3491551,325,120,50,220,170,50,50,Direct
3491819,275,95,35,150,115,35,35,Direct
3491687,75,0,40,250,210,40,40,Direct
3491785,75,0,35,180,145,35,35,Direct
3491853,150,5,50,275,225,50,50,Direct
3492053,225,25,35,225,190,35,35,Direct
3492219,175,20,25,75,50,25,25,Direct
3479383,250,75,20,135,115,20,20,Direct
3479347,50,0,20,135,115,20,20,Direct
3479490,225,35,20,155,135,20,20,Direct
3479797,200,10,20,75,55,20,20,Direct
3479876,175,5,50,205,155,50,50,Direct
3479890,225,40,50,220,170,50,50,Direct
3479990,275,75,36,121,85,36,36,Direct
3480076,200,5,40,235,195,40,40,Direct
3480319,100,0,35,180,145,35,35,Direct
3480340,200,20,35,155,120,35,35,Direct
3480433,175,10,25,75,50,25,25,Direct
3480483,250,50,20,160,140,20,20,Direct
3480676,150,0,20,75,55,20,20,Direct
3481276,175,15,35,175,140,35,35,Direct
3481519,125,0,20,180,160,20,20,Direct
3482062,50,0,35,165,130,35,35,Direct
3482105,225,30,20,75,55,20,20,Direct
3482341,175,10,50,240,190,50,50,Direct
3482355,550,235,50,365,315,50,50,Direct
3482398,100,0,35,165,130,35,35,Direct
3482205,200,25,58,128,70,58,58,Direct
3482934,0,0,20,160,140,20,20,Direct
3482248,75,0,35,125,90,35,35,Direct
3482498,225,45,35,140,105,35,35,Direct
3483184,275,95,20,140,120,20,20,Direct
3483377,175,5,35,190,155,35,35,Direct
3483391,225,45,35,150,115,35,35,Direct
3483427,125,0,50,210,160,50,50,Direct
3483734,200,20,50,210,160,50,50,Direct
3483777,200,30,35,180,145,35,35,Direct
3483870,225,30,50,245,195,50,50,Direct
3484084,225,35,20,155,135,20,20,Direct
3484127,125,0,20,140,120,20,20,Direct
3484234,250,50,20,195,175,20,20,Direct
3484277,300,100,75,350,275,75,75,Direct
3484363,200,15,40,295,255,40,40,Direct
3484770,175,5,35,185,150,35,35,Direct
3484863,125,0,25,65,40,25,25,Direct
3485206,175,15,20,160,140,20,20,Direct
3485220,175,15,35,260,225,35,35,Direct
3483148,125,0,35,170,135,35,35,Direct
3485306,325,115,50,210,160,50,50,Direct
3485349,125,0,40,200,160,40,40,Direct
3485363,75,0,35,175,140,35,35,Direct
3485563,50,0,35,140,105,35,35,Direct
3485906,275,75,50,285,235,50,50,Direct
3484263,125,0,20,75,55,20,20,Direct
3486092,275,95,50,325,275,50,50,Direct
3486192,375,120,50,235,185,50,50,Direct
3486285,150,0,50,260,210,50,50,Direct
3482984,400,190,50,290,240,50,50,Direct
3486785,175,5,35,145,110,35,35,Direct
3487221,150,0,35,150,115,35,35,Direct
3487278,75,0,20,170,150,20,20,Direct
3486978,100,0,35,225,190,35,35,Direct
3488759,125,0,40,265,225,40,40,Direct
3488961,175,10,35,145,110,35,35,Direct
3473234,200,10,35,180,145,35,35,Direct
3458243,75,0,35,235,200,35,35,Direct
3489346,200,20,20,130,110,20,20,Direct
3489597,175,10,35,190,155,35,35,Direct
3489695,150,5,50,200,150,50,50,Direct
3490148,225,35,50,375,325,50,50,Direct
3484366,300,80,40,265,225,40,40,Direct
3490248,300,85,20,160,140,20,20,Direct
3490282,75,0,20,80,60,20,20,Direct
3490884,300,70,50,230,180,50,50,Direct
3476593,350,130,40,285,245,40,40,Direct
3491084,200,15,20,140,120,20,20,Direct
3491169,325,70,50,225,175,50,50,Direct
3491384,200,15,35,150,115,35,35,Direct
3491403,200,5,40,230,190,40,40,Direct
3491620,200,50,20,130,110,20,20,Direct
3491720,175,5,35,160,125,35,35,Direct
3492105,250,65,20,160,140,20,20,Direct
3492169,175,5,50,275,225,50,50,Direct
3492320,200,25,20,90,70,20,20,Direct
3492605,100,0,35,265,230,35,35,Direct
3492703,300,110,50,275,225,50,50,Direct
3492839,175,15,35,165,130,35,35,Direct
3492990,175,5,35,210,175,35,35,Direct
3493054,450,145,35,260,225,35,35,Direct
3493205,200,10,50,220,170,50,50,Direct
3493392,125,0,20,160,140,20,20,Direct
3493390,125,0,35,125,90,35,35,Direct
3406301,225,25,15,70,55,15,15,Direct
3494126,100,0,35,170,135,35,35,Direct
3492656,125,0,20,190,170,20,20,Direct
3486002,125,0,35,150,115,35,35,Direct
3494528,200,30,35,150,115,35,35,Direct
3494577,200,30,20,160,140,20,20,Direct
3495562,175,10,50,275,225,50,50,Direct
3495611,250,65,35,155,120,35,35,Direct
3482979,100,0,35,175,140,35,35,Direct
3495862,175,15,35,150,115,35,35,Direct
3495947,200,20,60,110,50,60,60,Direct
3495949,175,15,20,190,170,20,20,Direct
3495964,125,0,35,150,115,35,35,Direct
3495962,200,35,35,180,145,35,35,Direct
3496200,100,0,60,125,65,60,60,Direct
3496213,175,10,35,185,150,35,35,Direct
3496249,225,35,35,270,235,35,35,Direct
3496347,400,140,50,375,325,50,50,Direct
3496349,100,0,50,235,185,50,50,Direct
3480028,150,0,50,190,140,50,50,Direct
3480177,300,100,50,200,150,50,50,Direct
3480278,200,55,35,190,155,35,35,Direct
3480363,175,10,50,225,175,50,50,Direct
3480496,200,10,50,275,225,50,50,Direct
3480513,50,0,35,265,230,35,35,Direct
3480645,75,0,20,120,100,20,20,Direct
3480913,275,90,50,275,225,50,50,Direct
3481167,250,40,20,80,60,20,20,Direct
3481414,150,0,50,215,165,50,50,Direct
3481482,125,0,20,190,170,20,20,Direct
3481500,100,0,35,120,85,35,35,Direct
3468378,325,100,50,325,275,50,50,Direct
3481785,75,0,35,125,90,35,35,Direct
3481985,225,30,35,170,135,35,35,Direct
3482103,175,5,35,155,120,35,35,Direct
3482554,150,0,50,210,160,50,50,Direct
3482635,150,5,35,180,145,35,35,Direct
3482785,250,50,50,240,190,50,50,Direct
3468063,250,55,35,155,120,35,35,Direct
3458754,100,0,35,180,145,35,35,Direct
3483504,125,0,35,225,190,35,35,Direct
3483589,250,60,20,180,160,20,20,Direct
3483639,175,20,50,230,180,50,50,Direct
3483857,175,15,23,93,70,23,23,Direct
3484308,250,55,50,265,215,50,50,Direct
3484439,175,15,60,155,95,60,60,Direct
3484490,175,10,50,230,180,50,50,Direct
3484657,175,5,20,75,55,20,20,Direct
3484775,100,0,35,150,115,35,35,Direct
3484826,75,0,20,170,150,20,20,Direct
3484890,100,0,35,190,155,35,35,Direct
3484907,175,20,35,145,110,35,35,Direct
3485026,25,0,50,230,180,50,50,Direct
3485111,300,115,75,390,315,75,75,Direct
3485311,225,35,35,155,120,35,35,Direct
3481968,275,120,50,250,200,50,50,Direct
3485776,125,0,35,150,115,35,35,Direct
3486230,300,95,35,180,145,35,35,Direct
3486312,100,0,35,165,130,35,35,Direct
3486329,175,15,50,235,185,50,50,Direct
3486380,225,80,35,125,90,35,35,Direct
3486511,75,0,50,210,160,50,50,Direct
3486579,200,30,35,235,200,35,35,Direct
3486916,125,0,35,140,105,35,35,Direct
3486997,350,85,35,270,235,35,35,Direct
3487116,100,0,50,255,205,50,50,Direct
3503808,175,15,50,375,325,50,50,Direct
3503915,175,10,20,160,140,20,20,Direct
3503922,100,0,35,100,65,35,35,Direct
3503958,125,0,35,125,90,35,35,Direct
3504065,325,155,50,265,215,50,50,Direct
3504072,0,0,35,225,190,35,35,Direct
3504601,125,0,10,20,10,10,10,Direct
3504801,100,0,35,150,115,35,35,Direct
3504808,50,0,50,275,225,50,50,Direct
3505137,125,0,40,250,210,40,40,Direct
3505351,75,0,36,136,100,36,36,Direct
3505387,100,0,35,130,95,35,35,Direct
3505394,75,0,35,135,100,35,35,Direct
3504558,375,120,50,220,170,50,50,Direct
3505687,175,10,20,140,120,20,20,Direct
3505830,200,40,35,180,145,35,35,Direct
3505944,200,15,35,155,120,35,35,Direct
3505987,175,15,25,90,65,25,25,Direct
3506037,150,0,35,145,110,35,35,Direct
3506137,300,90,50,280,230,50,50,Direct
3506237,100,0,50,265,215,50,50,Direct
3506280,125,0,20,140,120,20,20,Direct
3506337,225,35,35,195,160,35,35,Direct
3503629,175,10,50,275,225,50,50,Direct
3506616,100,0,35,125,90,35,35,Direct
3506637,75,0,35,165,130,35,35,Direct
3506823,200,55,50,200,150,50,50,Direct
3507066,150,0,50,225,175,50,50,Direct
3485045,250,45,35,180,145,35,35,Direct
3507702,200,25,50,275,225,50,50,Direct
3507759,450,140,20,170,150,20,20,Direct
3507816,525,270,75,375,300,75,75,Direct
3507866,100,0,35,105,70,35,35,Direct
3507952,50,0,20,140,120,20,20,Direct
3508045,175,15,35,145,110,35,35,Direct
3508059,175,0,20,160,140,20,20,Direct
3508252,175,0,50,205,155,50,50,Direct
3508402,100,0,35,290,255,35,35,Direct
3508395,125,0,35,150,115,35,35,Direct
3508545,200,25,20,140,120,20,20,Direct
3508745,125,0,35,150,115,35,35,Direct
3508702,75,0,35,190,155,35,35,Direct
3509002,175,15,35,170,135,35,35,Direct
3509145,375,155,50,225,175,50,50,Direct
3478143,375,135,35,190,155,35,35,Direct
3509195,125,0,35,195,160,35,35,Direct
3509088,200,25,35,155,120,35,35,Direct
3509245,125,0,20,25,5,20,20,Direct
3509338,100,0,20,160,140,20,20,Direct
3509538,275,75,35,240,205,35,35,Direct
3510017,350,135,110,400,290,110,110,Direct
3510081,300,75,50,250,200,50,50,Direct
3510331,125,0,35,155,120,35,35,Direct
3510424,300,90,40,250,210,40,40,Direct
3510481,200,20,60,115,55,60,60,Direct
3510674,250,65,50,265,215,50,50,Direct
3509345,225,75,50,265,215,50,50,Direct
3472671,325,95,50,220,170,50,50,Direct
3472705,225,30,25,85,60,25,25,Direct
3472778,275,75,35,180,145,35,35,Direct
3472812,100,0,35,165,130,35,35,Direct
3470506,125,0,35,115,80,35,35,Direct
3473114,100,0,50,250,200,50,50,Direct
3473216,400,175,50,230,180,50,50,Direct
3473305,375,120,50,230,180,50,50,Direct
3473505,200,25,35,170,135,35,35,Direct
3474207,150,0,35,190,155,35,35,Direct
3474216,175,15,25,75,50,25,25,Direct
3474250,100,0,50,200,150,50,50,Direct
3474352,275,55,35,155,120,35,35,Direct
3474450,275,85,50,200,150,50,50,Direct
3474650,175,20,35,125,90,35,35,Direct
3474675,175,15,35,150,115,35,35,Direct
3474786,100,0,50,230,180,50,50,Direct
3474850,175,5,50,200,150,50,50,Direct
3475522,350,135,35,250,215,35,35,Direct
3418723,175,15,35,165,130,35,35,Direct
3475645,500,215,75,350,275,75,75,Direct
3475654,200,15,50,235,185,50,50,Direct
3475845,75,0,20,140,120,20,20,Direct
3475854,225,30,35,190,155,35,35,Direct
3476020,300,100,35,195,160,35,35,Direct
3476224,250,65,35,135,100,35,35,Direct
3476381,175,10,50,255,205,50,50,Direct
3476458,75,0,0,5,5,0,0,Direct
3476683,200,15,25,90,65,25,25,Direct
3477015,250,50,35,190,155,35,35,Direct
3477049,225,55,35,190,155,35,35,Direct
3477185,175,0,35,160,125,35,35,Direct
3477458,75,0,50,200,150,50,50,Direct
3477526,175,0,20,165,145,20,20,Direct
3478062,500,215,50,275,225,50,50,Direct
3466689,150,0,35,165,130,35,35,Direct
3478453,125,0,20,75,55,20,20,Direct
3478521,175,0,50,250,200,50,50,Direct
3478687,200,25,35,180,145,35,35,Direct
3478755,200,30,35,270,235,35,35,Direct
3479023,375,150,35,195,160,35,35,Direct
3463554,275,75,35,160,125,35,35,Direct
3479262,125,0,35,245,210,35,35,Direct
3389984,300,100,35,165,130,35,35,Direct
3479398,175,15,35,100,65,35,35,Direct
3479432,175,10,35,150,115,35,35,Direct
3479491,100,0,40,215,175,40,40,Direct
3479589,125,0,35,170,135,35,35,Direct
3479798,225,45,35,130,95,35,35,Direct
3471324,375,100,35,195,160,35,35,Direct
3471517,200,20,75,335,260,75,75,Direct
3471560,175,10,35,150,115,35,35,Direct
3471653,150,0,35,190,155,35,35,Direct
3471817,75,0,50,255,205,50,50,Direct
3471851,275,65,35,135,100,35,35,Direct
3472094,275,75,35,170,135,35,35,Direct
3466778,200,35,35,170,135,35,35,Direct
3472353,75,0,20,30,10,20,20,Direct
3472487,175,5,35,155,120,35,35,Direct
3472530,275,70,35,250,215,35,35,Direct
3472689,350,130,50,280,230,50,50,Direct
3472723,200,10,35,170,135,35,35,Direct
3472753,225,30,40,325,285,40,40,Direct
3472830,125,0,40,255,215,40,40,Direct
3472996,75,0,35,125,90,35,35,Direct
3470081,225,50,40,295,255,40,40,Direct
3473123,125,0,35,195,160,35,35,Direct
3473230,75,0,20,75,55,20,20,Direct
3473489,75,0,20,25,5,20,20,Direct
3473525,125,0,35,160,125,35,35,Direct
3473625,175,10,20,170,150,20,20,Direct
3379095,325,85,35,180,145,35,35,Direct
3473959,75,0,35,170,135,35,35,Direct
3474123,325,100,35,160,125,35,35,Direct
3474302,275,50,50,310,260,50,50,Direct
3474466,125,0,35,175,140,35,35,Direct
3474459,175,15,50,270,220,50,50,Direct
3474668,200,30,35,140,105,35,35,Direct
3471951,225,60,35,140,105,35,35,Direct
3453367,175,15,25,85,60,25,25,Direct
3475295,225,25,60,165,105,60,60,Direct
3475368,225,35,50,265,215,50,50,Direct
3475395,325,95,35,145,110,35,35,Direct
3475497,225,50,50,275,225,50,50,Direct
3475738,150,0,50,215,165,50,50,Direct
3475604,200,20,50,325,275,50,50,Direct
3475840,275,75,75,300,225,75,75,Direct
3476197,250,50,35,165,130,35,35,Direct
3476274,200,20,35,180,145,35,35,Direct
3476531,200,20,35,190,155,35,35,Direct
3436564,200,25,35,175,140,35,35,Direct
3476497,225,45,25,75,50,25,25,Direct
3476731,125,0,35,140,105,35,35,Direct
3476797,125,0,35,180,145,35,35,Direct
3476874,75,0,35,150,115,35,35,Direct
3477133,200,20,35,145,110,35,35,Direct
3477269,100,0,50,220,170,50,50,Direct
3477333,350,125,20,160,140,20,20,Direct
3477367,300,75,50,275,225,50,50,Direct
3477469,50,0,35,170,135,35,35,Direct
3477603,325,120,35,260,225,35,35,Direct
3504704,250,70,20,140,120,20,20,Direct
3505308,275,75,50,250,200,50,50,Direct
3505406,275,40,35,240,205,35,35,Direct
3505640,100,0,25,95,70,25,25,Direct
3505657,225,45,35,215,180,35,35,Direct
3506108,275,80,35,170,135,35,35,Direct
3506193,200,20,20,160,140,20,20,Direct
3506274,350,135,35,260,225,35,35,Direct
3506125,250,50,110,405,295,110,110,Direct
3506861,175,10,35,150,115,35,35,Direct
3507027,150,0,50,275,225,50,50,Direct
3507261,100,0,50,250,200,50,50,Direct
3507278,100,0,35,165,130,35,35,Direct
3501364,75,0,20,170,150,20,20,Direct
3490464,250,45,35,155,120,35,35,Direct
3507729,150,0,35,195,160,35,35,Direct
3507980,250,50,35,125,90,35,35,Direct
3508333,225,45,35,135,100,35,35,Direct
3508397,100,0,35,190,155,35,35,Direct
3508414,125,0,50,235,185,50,50,Direct
3508465,175,0,35,175,140,35,35,Direct
3503670,300,140,75,350,275,75,75,Direct
3508750,50,0,35,175,140,35,35,Direct
3508831,75,0,35,160,125,35,35,Direct
3508146,225,30,50,240,190,50,50,Direct
3509252,525,220,150,375,225,150,150,Direct
3509733,300,100,50,355,305,50,50,Direct
3509869,150,0,35,105,70,35,35,Direct
3509954,75,0,35,190,155,35,35,Direct
3510452,400,135,50,260,210,50,50,Direct
3510571,175,10,60,155,95,60,60,Direct
3510673,175,15,50,265,215,50,50,Direct
3511005,300,70,50,200,150,50,50,Direct
3507461,200,25,75,310,235,75,75,Direct
3509035,250,55,20,160,140,20,20,Direct
3511290,200,40,35,160,125,35,35,Direct
3511639,75,0,35,115,80,35,35,Direct
3511826,150,0,35,140,105,35,35,Direct
3511975,150,0,20,170,150,20,20,Direct
3512524,375,135,20,170,150,20,20,Direct
3512843,50,0,20,130,110,20,20,Direct
3512877,225,30,35,155,120,35,35,Direct
3513230,150,5,20,95,75,20,20,Direct
3513464,125,0,20,25,5,20,20,Direct
3513915,350,105,35,260,225,35,35,Direct
3514115,200,15,35,260,225,35,35,Direct
3514315,225,45,25,80,55,25,25,Direct
3514447,125,0,35,160,125,35,35,Direct
3514515,100,0,35,175,140,35,35,Direct
3514549,200,25,50,235,185,50,50,Direct
3514617,225,30,35,150,115,35,35,Direct
3514898,125,0,35,260,225,35,35,Direct
3489749,100,0,35,175,140,35,35,Direct
3514349,100,0,15,70,55,15,15,Direct
3514583,225,25,35,275,240,35,35,Direct
3515736,150,0,35,140,105,35,35,Direct
3515753,125,0,50,205,155,50,50,Direct
3515817,200,25,100,230,130,100,100,Direct
3515868,450,140,50,285,235,50,50,Direct
3484656,225,45,40,275,235,40,40,Direct
3484777,125,0,35,180,145,35,35,Direct
3484891,175,10,35,190,155,35,35,Direct
3485042,150,0,35,155,120,35,35,Direct
3485228,325,100,50,250,200,50,50,Direct
3485442,75,0,20,80,60,20,20,Direct
3485578,125,0,35,155,120,35,35,Direct
3485592,375,135,35,185,150,35,35,Direct
3485677,250,70,50,275,225,50,50,Direct
3485827,75,0,20,65,45,20,20,Direct
3485913,150,0,50,235,185,50,50,Direct
3485977,75,0,35,135,100,35,35,Direct
3486328,200,10,35,125,90,35,35,Direct
3486799,250,50,75,350,275,75,75,Direct
3486864,225,45,35,180,145,35,35,Direct
3486914,200,25,35,150,115,35,35,Direct
3487064,225,60,35,195,160,35,35,Direct
3487214,400,140,50,250,200,50,50,Direct
3487500,300,100,35,185,150,35,35,Direct
3487785,325,90,50,240,190,50,50,Direct
3487935,275,55,35,175,140,35,35,Direct
3487835,325,135,50,265,215,50,50,Direct
3488735,150,0,35,150,115,35,35,Direct
3489086,100,0,35,150,115,35,35,Direct
3485777,375,130,35,170,135,35,35,Direct
3474596,100,0,35,190,155,35,35,Direct
3489222,75,0,35,195,160,35,35,Direct
3466258,200,25,35,125,90,35,35,Direct
3449845,175,5,35,150,115,35,35,Direct
3489422,225,40,50,225,175,50,50,Direct
3489571,225,30,35,175,140,35,35,Direct
3489772,100,0,20,160,140,20,20,Direct
3490072,200,10,35,185,150,35,35,Direct
3490107,125,0,20,80,60,20,20,Direct
3490121,150,0,50,250,200,50,50,Direct
3489321,150,0,35,160,125,35,35,Direct
3491208,275,70,110,425,315,110,110,Direct
3472774,350,130,35,170,135,35,35,Direct
3491693,75,0,35,195,160,35,35,Direct
3491779,375,135,35,180,145,35,35,Direct
3492179,150,0,35,150,115,35,35,Direct
3492330,200,30,50,255,205,50,50,Direct
3491643,200,30,50,230,180,50,50,Direct
3492444,375,120,75,315,240,75,75,Direct
3434619,225,35,50,235,185,50,50,Direct
3492865,150,0,35,200,165,35,35,Direct
3492916,75,0,35,250,215,35,35,Direct
3492929,400,160,50,280,230,50,50,Direct
3493180,175,15,20,145,125,20,20,Direct
3493365,0,0,35,245,210,35,35,Direct
3493380,200,30,35,130,95,35,35,Direct
3493416,125,0,35,140,105,35,35,Direct
3493516,200,30,25,95,70,25,25,Direct
3493751,125,0,50,200,150,50,50,Direct
3493766,175,5,50,200,150,50,50,Direct
3510121,175,15,50,275,225,50,50,Direct
3510185,150,0,40,215,175,40,40,Direct
3510336,200,25,35,190,155,35,35,Direct
3510285,200,35,20,60,40,20,20,Direct
3485334,175,15,20,165,145,20,20,Direct
3511321,75,0,35,165,130,35,35,Direct
3511355,100,0,35,250,215,35,35,Direct
3511406,200,30,35,260,225,35,35,Direct
3510970,75,0,50,375,325,50,50,Direct
3511608,75,0,20,160,140,20,20,Direct
3511657,175,15,50,265,215,50,50,Direct
3512093,125,0,35,170,135,35,35,Direct
3512291,75,0,35,195,160,35,35,Direct
3512408,175,5,50,205,155,50,50,Direct
3512744,200,25,50,275,225,50,50,Direct
3513163,150,0,50,200,150,50,50,Direct
3505090,225,35,35,130,95,35,35,Direct
3513780,100,0,20,180,160,20,20,Direct
3514114,75,0,20,130,110,20,20,Direct
3514314,100,0,35,140,105,35,35,Direct
3512929,325,160,40,275,235,40,40,Direct
3514399,25,0,35,190,155,35,35,Direct
3514516,425,145,50,265,215,50,50,Direct
3514680,125,0,20,180,160,20,20,Direct
3514814,200,30,35,150,115,35,35,Direct
3514365,850,555,400,1000,600,400,400,Direct
3515001,175,0,50,285,235,50,50,Direct
3515401,125,0,35,250,215,35,35,Direct
3510170,225,30,35,150,115,35,35,Direct
3511291,150,0,35,155,120,35,35,Direct
3509683,150,0,35,175,140,35,35,Direct
3499640,225,45,35,125,90,35,35,Direct
3515586,275,60,35,165,130,35,35,Direct
3515735,250,55,80,400,320,80,80,Direct
3515837,175,5,20,170,150,20,20,Direct
3490901,200,15,35,170,135,35,35,Direct
3515886,175,10,35,190,155,35,35,Direct
3516001,125,0,35,195,160,35,35,Direct
3516101,175,20,20,160,140,20,20,Direct
3516071,225,35,25,65,40,25,25,Direct
3516388,200,30,35,150,115,35,35,Direct
3516588,200,30,50,385,335,50,50,Direct
3516686,525,220,50,290,240,50,50,Direct
3516671,300,90,50,275,225,50,50,Direct
3516886,100,0,20,45,25,20,20,Direct
3517022,100,0,5,10,5,5,5,Direct
3517071,150,0,50,230,180,50,50,Direct
3517373,200,40,50,200,150,50,50,Direct
3517358,225,40,50,260,210,50,50,Direct
3517624,175,5,35,190,155,35,35,Direct
3517824,100,0,20,170,150,20,20,Direct
3517873,125,0,35,190,155,35,35,Direct
3517907,75,0,20,35,15,20,20,Direct
3518024,175,5,20,65,45,20,20,Direct
3518543,225,35,50,375,325,50,50,Direct
3493865,400,170,40,375,335,40,40,Direct
3493866,200,30,35,150,115,35,35,Direct
3493966,100,0,35,170,135,35,35,Direct
3493965,125,0,35,185,150,35,35,Direct
3494101,100,0,35,175,140,35,35,Direct
3494416,200,25,35,235,200,35,35,Direct
3449095,125,0,25,80,55,25,25,Direct
3494751,75,0,35,170,135,35,35,Direct
3494951,300,75,35,150,115,35,35,Direct
3495138,225,40,35,140,105,35,35,Direct
3495202,325,105,50,200,150,50,50,Direct
3495287,325,95,50,240,190,50,50,Direct
3495438,225,45,35,185,150,35,35,Direct
3495738,325,130,35,225,190,35,35,Direct
3496024,175,5,35,150,115,35,35,Direct
3496088,250,65,35,150,115,35,35,Direct
3496124,325,90,40,260,220,40,40,Direct
3496338,175,0,40,230,190,40,40,Direct
3496574,150,0,20,130,110,20,20,Direct
3496623,175,20,50,240,190,50,50,Direct
3496674,225,45,35,225,190,35,35,Direct
3496709,100,0,20,160,140,20,20,Direct
3496824,250,40,50,275,225,50,50,Direct
3497060,200,25,20,170,150,20,20,Direct
3497110,200,15,35,135,100,35,35,Direct
3497209,200,30,30,140,110,30,30,Direct
3497460,300,85,50,330,280,50,50,Direct
3497510,350,105,35,155,120,35,35,Direct
3497560,75,0,20,95,75,20,20,Direct
3497945,200,30,24,89,65,24,24,Direct
3497996,100,0,20,120,100,20,20,Direct
3498246,100,0,35,155,120,35,35,Direct
3498531,175,20,35,170,135,35,35,Direct
3498596,250,65,35,155,120,35,35,Direct
3498646,100,0,20,95,75,20,20,Direct
3498731,200,20,50,280,230,50,50,Direct
3499196,175,10,20,120,100,20,20,Direct
3499246,175,5,35,150,115,35,35,Direct
3499231,75,0,35,130,95,35,35,Direct
3499331,175,15,20,80,60,20,20,Direct
3499482,175,10,35,185,150,35,35,Direct
3499582,175,15,20,160,140,20,20,Direct
3499631,75,0,20,50,30,20,20,Direct
3499831,175,10,35,180,145,35,35,Direct
3500417,150,0,50,275,225,50,50,Direct
3500467,150,0,35,195,160,35,35,Direct
3500718,375,135,20,160,140,20,20,Direct
3501018,150,0,35,185,150,35,35,Direct
3500753,250,45,20,85,65,20,20,Direct
3500954,150,0,35,140,105,35,35,Direct
3501103,175,10,50,275,225,50,50,Direct
3501153,75,0,40,205,165,40,40,Direct
3495375,225,15,50,230,180,50,50,Direct
3486883,200,30,50,250,200,50,50,Direct
3494857,125,0,35,110,75,35,35,Direct
3492235,100,0,35,180,145,35,35,Direct
3495775,175,5,35,130,95,35,35,Direct
3495861,75,0,35,180,145,35,35,Direct
3495950,175,15,20,180,160,20,20,Direct
3422457,175,10,35,145,110,35,35,Direct
3496111,200,25,50,205,155,50,50,Direct
3496129,75,0,25,85,60,25,25,Direct
3496150,125,0,35,150,115,35,35,Direct
3496329,225,55,35,180,145,35,35,Direct
3496368,100,0,35,260,225,35,35,Direct
3496579,100,0,50,235,185,50,50,Direct
3496618,50,0,35,280,245,35,35,Direct
3496904,75,0,60,150,90,60,60,Direct
3497022,275,75,35,240,205,35,35,Direct
3497111,100,0,50,375,325,50,50,Direct
3497115,375,120,35,160,125,35,35,Direct
3497447,100,0,33,123,90,33,33,Direct
3497422,175,20,18,43,25,18,18,Direct
3497572,100,0,50,215,165,50,50,Direct
3497690,200,30,37,137,100,37,37,Direct
3497822,325,100,50,325,275,50,50,Direct
3498251,125,0,18,33,15,18,18,Direct
3498383,75,0,20,165,145,20,20,Direct
3498508,400,155,50,250,200,50,50,Direct
3498651,100,0,35,125,90,35,35,Direct
3498783,75,0,50,200,150,50,50,Direct
3498801,175,0,50,250,200,50,50,Direct
3498894,150,0,60,110,50,60,60,Direct
3494725,125,0,50,275,225,50,50,Direct
3491831,250,45,25,75,50,25,25,Direct
3499444,300,105,50,200,150,50,50,Direct
3499451,225,25,35,165,130,35,35,Direct
3475712,150,0,35,230,195,35,35,Direct
3499937,150,5,50,275,225,50,50,Direct
3499987,150,0,35,190,155,35,35,Direct
3500030,250,50,75,330,255,75,75,Direct
3500337,175,10,35,235,200,35,35,Direct
3500405,350,130,50,295,245,50,50,Direct
3500473,275,80,50,325,275,50,50,Direct
3500498,175,5,20,45,25,20,20,Direct
3500516,275,75,35,260,225,35,35,Direct
3500523,100,0,20,135,115,20,20,Direct
3500537,200,10,50,220,170,50,50,Direct
3500591,125,0,50,250,200,50,50,Direct
3500698,250,40,50,220,170,50,50,Direct
3500673,225,25,35,135,100,35,35,Direct
3499426,125,0,50,375,325,50,50,Direct
3500723,200,25,35,155,120,35,35,Direct
3500741,300,70,35,225,190,35,35,Direct
3500805,125,0,20,75,55,20,20,Direct
3500966,225,35,40,275,235,40,40,Direct
3500991,250,65,75,325,250,75,75,Direct
3501005,175,10,35,180,145,35,35,Direct
3500323,175,10,35,150,115,35,35,Direct
3501473,450,145,50,205,155,50,50,Direct
3501609,150,5,35,260,225,35,35,Direct
3479557,175,15,35,150,115,35,35,Direct
3483242,250,65,35,265,230,35,35,Direct
3483667,175,5,20,140,120,20,20,Direct
3483842,275,75,35,190,155,35,35,Direct
3483969,400,140,50,250,200,50,50,Direct
3484403,225,0,50,205,155,50,50,Direct
3484603,100,0,35,170,135,35,35,Direct
3484169,400,160,50,275,225,50,50,Direct
3484646,200,5,34,154,120,34,34,Direct
3484744,350,105,50,230,180,50,50,Direct
3484769,225,45,34,164,130,34,34,Direct
3485003,200,0,50,250,200,50,50,Direct
3485348,300,85,50,250,200,50,50,Direct
3485505,200,20,20,150,130,20,20,Direct
3485807,225,30,35,165,130,35,35,Direct
3485939,225,25,35,240,205,35,35,Direct
3477349,75,0,35,105,70,35,35,Direct
3486577,175,5,35,125,90,35,35,Direct
3486718,225,55,35,210,175,35,35,Direct
3486786,200,30,50,220,170,50,50,Direct
3486884,125,0,35,190,155,35,35,Direct
3486909,325,90,35,150,115,35,35,Direct
3486918,225,60,50,205,155,50,50,Direct
3487054,125,0,20,85,65,20,20,Direct
3487084,100,0,35,225,190,35,35,Direct
3487152,325,85,50,230,180,50,50,Direct
3470338,100,0,35,135,100,35,35,Direct
3487645,200,35,50,220,170,50,50,Direct
3487956,175,15,60,110,50,60,60,Direct
3488156,100,0,35,155,120,35,35,Direct
3488224,75,0,35,165,130,35,35,Direct
3488390,150,0,40,235,195,40,40,Direct
3488624,350,105,50,215,165,50,50,Direct
3488658,175,15,50,200,150,50,50,Direct
3488790,100,0,20,175,155,20,20,Direct
3488858,200,15,20,160,140,20,20,Direct
3486650,175,10,35,220,185,35,35,Direct
3462518,275,60,35,135,100,35,35,Direct
3456191,250,55,35,255,220,35,35,Direct
3489317,225,30,40,230,190,40,40,Direct
3489385,100,0,35,155,120,35,35,Direct
3489424,75,0,35,125,90,35,35,Direct
3489619,225,40,20,95,75,20,20,Direct
3489785,300,65,20,95,75,20,20,Direct
3489624,250,50,35,240,205,35,35,Direct
3490160,200,45,20,160,140,20,20,Direct
3490453,300,100,50,230,180,50,50,Direct
3490619,175,5,50,325,275,50,50,Direct
3485650,500,195,40,285,245,40,40,Direct
3491053,100,0,50,275,225,50,50,Direct
3486743,175,20,35,155,120,35,35,Direct
3491087,100,0,50,230,180,50,50,Direct
3487109,400,160,35,220,185,35,35,Direct
3491330,150,0,35,145,110,35,35,Direct
3514503,125,0,50,265,215,50,50,Direct
3514769,200,20,50,250,200,50,50,Direct
3514969,200,30,50,275,225,50,50,Direct
3515169,125,0,35,165,130,35,35,Direct
3497864,300,100,35,180,145,35,35,Direct
3515782,0,0,20,100,80,20,20,Direct
3502571,75,0,25,85,60,25,25,Direct
3516082,175,5,35,150,115,35,35,Direct
3516275,250,100,20,130,110,20,20,Direct
3507658,200,25,35,180,145,35,35,Direct
3516348,175,10,50,300,250,50,50,Direct
3516439,100,0,35,170,135,35,35,Direct
3516441,125,0,35,185,150,35,35,Direct
3516682,325,105,35,155,120,35,35,Direct
3516675,225,45,35,175,140,35,35,Direct
3516777,200,20,40,275,235,40,40,Direct
3517141,125,0,25,95,70,25,25,Direct
3517177,150,0,25,80,55,25,25,Direct
3517411,175,5,35,200,165,35,35,Direct
3517477,225,45,36,161,125,36,36,Direct
3517211,50,0,35,170,135,35,35,Direct
3517511,375,150,49,209,160,49,49,Direct
3517711,200,30,35,125,90,35,35,Direct
3518111,100,0,75,325,250,75,75,Direct
3518320,100,0,20,80,60,20,20,Direct
3518456,100,0,20,170,150,20,20,Direct
3518654,275,55,35,190,155,35,35,Direct
3518756,175,15,40,240,200,40,40,Direct
3518790,350,100,50,210,160,50,50,Direct
3518847,100,0,35,150,115,35,35,Direct
3519047,75,0,50,205,155,50,50,Direct
3519056,125,0,20,95,75,20,20,Direct
3519249,125,0,20,140,120,20,20,Direct
3519492,50,0,35,160,125,35,35,Direct
3519783,450,170,50,260,210,50,50,Direct
3519890,50,0,35,170,135,35,35,Direct
3520085,200,25,60,195,135,60,60,Direct
3520328,125,0,50,215,165,50,50,Direct
3476165,200,25,35,180,145,35,35,Direct
3520392,175,5,50,260,210,50,50,Direct
3520592,150,0,50,235,185,50,50,Direct
3520821,175,20,40,325,285,40,40,Direct
3520928,150,0,25,85,60,25,25,Direct
3521019,0,0,50,275,225,50,50,Direct
3521085,100,0,20,90,70,20,20,Direct
3521119,75,0,37,132,95,37,37,Direct
3521128,175,10,50,225,175,50,50,Direct
3521328,375,120,75,375,300,75,75,Direct
3521321,325,110,50,195,145,50,50,Direct
3521421,50,0,35,175,140,35,35,Direct
3521455,125,0,35,115,80,35,35,Direct
3521562,425,115,35,295,260,35,35,Direct
3521755,175,10,35,115,80,35,35,Direct
3521762,100,0,35,165,130,35,35,Direct
3468082,225,40,35,150,115,35,35,Direct
3522264,250,50,50,205,155,50,50,Direct
3516182,100,0,35,180,145,35,35,Direct
3522464,150,0,20,95,75,20,20,Direct
3522598,100,0,20,135,115,20,20,Direct
3503680,75,0,35,135,100,35,35,Direct
3522834,300,100,35,185,150,35,35,Direct
3523300,250,55,50,375,325,50,50,Direct
3523400,150,0,35,180,145,35,35,Direct
3500062,175,15,35,190,155,35,35,Direct
3511251,125,0,35,145,110,35,35,Direct
3511312,200,10,35,225,190,35,35,Direct
3511337,200,40,50,265,215,50,50,Direct
3487787,225,35,50,275,225,50,50,Direct
3511426,125,0,50,260,210,50,50,Direct
3511512,175,15,35,255,220,35,35,Direct
3511587,175,15,50,230,180,50,50,Direct
3512005,75,0,50,200,150,50,50,Direct
3512055,150,0,20,75,55,20,20,Direct
3512230,225,45,35,265,230,35,35,Direct
3512587,200,20,55,300,245,55,55,Direct
3512766,175,10,25,70,45,25,25,Direct
3512791,300,80,35,210,175,35,35,Direct
3513141,75,0,50,280,230,50,50,Direct
3513191,100,0,20,140,120,20,20,Direct
3513248,75,0,35,185,150,35,35,Direct
3513298,175,10,50,265,215,50,50,Direct
3513566,175,5,35,150,115,35,35,Direct
3513902,125,0,35,260,225,35,35,Direct
3514745,200,40,40,200,160,40,40,Direct
3427080,200,35,35,175,140,35,35,Direct
3514770,100,0,35,195,160,35,35,Direct
3514838,100,0,35,150,115,35,35,Direct
3514877,175,10,35,165,130,35,35,Direct
3515102,175,5,50,215,165,50,50,Direct
3515263,175,5,50,315,265,50,50,Direct
3508304,275,60,35,260,225,35,35,Direct
3495025,325,95,20,120,100,20,20,Direct
3516056,100,0,35,145,110,35,35,Direct
3516242,175,5,35,190,155,35,35,Direct
3516217,300,85,50,225,175,50,50,Direct
3516306,375,120,35,230,195,35,35,Direct
3516642,50,0,50,245,195,50,50,Direct
3516710,100,0,50,235,185,50,50,Direct
3516860,225,30,35,155,120,35,35,Direct
3516992,175,15,35,135,100,35,35,Direct
3511451,100,0,50,230,180,50,50,Direct
3515813,175,20,20,75,55,20,20,Direct
3517267,175,0,20,120,100,20,20,Direct
3517528,100,0,27,92,65,27,27,Direct
3517660,200,30,35,160,125,35,35,Direct
3517685,175,15,100,250,150,100,100,Direct
3517728,350,125,50,240,190,50,50,Direct
3517871,100,0,20,130,110,20,20,Direct
3517928,200,20,50,230,180,50,50,Direct
3518046,225,35,50,200,150,50,50,Direct
3518271,250,50,35,175,140,35,35,Direct
3518221,250,60,35,150,115,35,35,Direct
3518353,325,135,50,255,205,50,50,Direct
3518396,175,10,50,220,170,50,50,Direct
3518757,100,0,20,140,120,20,20,Direct
3492453,225,30,20,130,110,20,20,Direct
3492623,200,10,50,200,150,50,50,Direct
3492653,175,15,50,340,290,50,50,Direct
3492670,300,75,20,180,160,20,20,Direct
3492704,250,65,20,175,155,20,20,Direct
3492904,175,10,50,250,200,50,50,Direct
3493074,175,5,35,140,105,35,35,Direct
3493138,175,0,20,75,55,20,20,Direct
3493257,175,10,50,295,245,50,50,Direct
3493291,50,0,20,185,165,20,20,Direct
3493355,175,10,50,300,250,50,50,Direct
3493657,175,0,50,205,155,50,50,Direct
3493891,175,10,50,300,250,50,50,Direct
3493908,425,115,50,265,215,50,50,Direct
3494010,200,25,50,220,170,50,50,Direct
3494125,200,15,35,120,85,35,35,Direct
3494478,125,0,50,210,160,50,50,Direct
3494610,150,0,50,235,185,50,50,Direct
3494678,175,5,20,185,165,20,20,Direct
3494695,200,25,25,95,70,25,25,Direct
3494776,200,30,20,150,130,20,20,Direct
3494912,25,0,50,215,165,50,50,Direct
3495010,175,5,50,250,200,50,50,Direct
3448048,75,0,35,245,210,35,35,Direct
3495478,100,0,35,185,150,35,35,Direct
3495580,625,335,125,590,465,125,125,Direct
3486373,175,15,25,80,55,25,25,Direct
3491585,175,10,20,170,150,20,20,Direct
3491653,225,35,35,180,145,35,35,Direct
3487207,100,0,20,160,140,20,20,Direct
3478200,75,0,35,105,70,35,35,Direct
3495678,75,0,35,115,80,35,35,Direct
3495831,175,10,35,130,95,35,35,Direct
3496146,100,0,20,170,150,20,20,Direct
3496431,75,0,20,35,15,20,20,Direct
3496933,175,15,35,175,140,35,35,Direct
3496984,150,0,60,195,135,60,60,Direct
3497116,50,0,25,70,45,25,25,Direct
3497235,25,0,50,230,180,50,50,Direct
3497286,175,5,35,150,115,35,35,Direct
3497533,225,45,35,190,155,35,35,Direct
3497469,125,0,50,280,230,50,50,Direct
3497784,1175,625,400,1185,785,400,400,Direct
3497771,350,130,35,180,145,35,35,Direct
3497852,200,25,35,145,110,35,35,Direct
3497988,100,0,50,255,205,50,50,Direct
3498035,125,0,20,80,60,20,20,Direct
3498656,100,0,20,50,30,20,20,Direct
3498673,200,20,35,150,115,35,35,Direct
3498856,250,50,35,210,175,35,35,Direct
3498907,75,0,50,250,200,50,50,Direct
3499022,175,0,40,230,190,40,40,Direct
3449903,150,0,35,160,125,35,35,Direct
3499290,225,45,25,80,55,25,25,Direct
3491389,75,0,20,30,10,20,20,Direct
3491432,375,165,140,650,510,140,140,Direct
3491496,225,35,35,155,120,35,35,Direct
3492023,350,105,35,190,155,35,35,Direct
3492100,225,35,35,245,210,35,35,Direct
3492359,200,25,50,375,325,50,50,Direct
3492500,150,0,50,225,175,50,50,Direct
3492636,225,55,40,345,305,40,40,Direct
3492568,75,0,10,20,10,10,10,Direct
3492198,200,15,50,235,185,50,50,Direct
3492768,50,0,35,225,190,35,35,Direct
3492861,175,5,50,280,230,50,50,Direct
3493036,50,0,20,170,150,20,20,Direct
3493100,0,0,20,175,155,20,20,Direct
3493359,125,0,35,160,125,35,35,Direct
3493704,175,15,35,175,140,35,35,Direct
3493861,75,0,20,80,60,20,20,Direct
3494031,150,0,35,180,145,35,35,Direct
3494129,200,15,50,300,250,50,50,Direct
3494440,250,105,20,170,150,20,20,Direct
3494763,150,0,35,165,130,35,35,Direct
3494772,200,25,20,160,140,20,20,Direct
3494865,425,145,50,250,200,50,50,Direct
3494997,175,0,75,300,225,75,75,Direct
3494933,175,5,50,315,265,50,50,Direct
3495299,150,0,35,170,135,35,35,Direct
3491632,150,0,35,190,155,35,35,Direct
3488254,75,0,35,160,125,35,35,Direct
3495810,225,45,35,140,105,35,35,Direct
3495878,100,0,20,80,60,20,20,Direct
3496001,250,50,35,150,115,35,35,Direct
3496035,100,0,35,265,230,35,35,Direct
3496103,275,65,50,250,200,50,50,Direct
3496167,125,0,25,80,55,25,25,Direct
3496210,100,0,50,230,180,50,50,Direct
3496312,125,0,20,75,55,20,20,Direct
3496371,225,25,35,190,155,35,35,Direct
3496410,75,0,20,155,135,20,20,Direct
3496512,100,0,35,125,90,35,35,Direct
3496703,150,0,35,290,255,35,35,Direct
3496780,250,65,35,160,125,35,35,Direct
3496903,125,0,50,200,150,50,50,Direct
3497005,200,30,50,225,175,50,50,Direct
3497039,125,0,20,180,160,20,20,Direct
3497048,225,30,35,140,105,35,35,Direct
3497078,175,5,20,175,155,20,20,Direct
3497380,100,0,60,110,50,60,60,Direct
3497405,175,10,35,150,115,35,35,Direct
3497448,150,0,35,160,125,35,35,Direct
3497507,225,25,35,140,105,35,35,Direct
3497541,200,20,50,275,225,50,50,Direct
3497639,50,0,50,280,230,50,50,Direct
3497814,175,5,50,200,150,50,50,Direct
3497950,625,335,55,430,375,55,55,Direct
3478421,175,0,20,155,135,20,20,Direct
3498141,225,35,35,225,190,35,35,Direct
3498209,375,120,35,160,125,35,35,Direct
3519025,100,0,35,180,145,35,35,Direct
3519046,175,10,60,110,50,60,60,Direct
3519064,100,0,25,75,50,25,25,Direct
3429645,125,0,35,100,65,35,35,Direct
3519250,50,0,50,200,150,50,50,Direct
3519514,275,80,35,165,130,35,35,Direct
3519518,300,140,50,225,175,50,50,Direct
3519532,350,140,50,280,230,50,50,Direct
3519800,225,45,35,105,70,35,35,Direct
3512780,200,15,20,160,140,20,20,Direct
3520143,75,0,20,140,120,20,20,Direct
3520536,100,0,35,100,65,35,35,Direct
3521254,100,0,35,145,110,35,35,Direct
3521229,300,80,50,240,190,50,50,Direct
3521322,175,10,35,190,155,35,35,Direct
3521336,50,0,40,230,190,40,40,Direct
3521404,125,0,35,190,155,35,35,Direct
3521411,150,0,100,200,100,100,100,Direct
3520136,200,25,20,180,160,20,20,Direct
3521790,200,10,35,120,85,35,35,Direct
3521965,175,0,35,125,90,35,35,Direct
3522458,175,5,35,225,190,35,35,Direct
3522483,25,0,20,65,45,20,20,Direct
3522658,175,15,20,75,55,20,20,Direct
3522994,150,0,25,65,40,25,25,Direct
3523126,200,20,50,240,190,50,50,Direct
3523194,100,0,35,190,155,35,35,Direct
3523437,75,0,35,150,115,35,35,Direct
3523544,225,45,20,180,160,20,20,Direct
3523594,250,70,20,160,140,20,20,Direct
3523612,225,30,50,275,225,50,50,Direct
3522501,200,25,35,150,115,35,35,Direct
3523744,250,50,50,250,200,50,50,Direct
3492667,300,90,35,170,135,35,35,Direct
3520275,125,0,35,135,100,35,35,Direct
3524280,225,40,35,150,115,35,35,Direct
3524330,150,0,35,245,210,35,35,Direct
3524348,125,0,35,170,135,35,35,Direct
3524462,100,0,35,120,85,35,35,Direct
3524612,200,20,20,190,170,20,20,Direct
3524623,525,220,35,290,255,35,35,Direct
3524662,175,5,25,50,25,25,25,Direct
3524798,125,0,20,65,45,20,20,Direct
3524823,200,20,40,200,160,40,40,Direct
3524880,125,0,50,275,225,50,50,Direct
3525148,225,45,35,165,130,35,35,Direct
3467106,450,145,35,270,235,35,35,Direct
3525573,25,0,35,150,115,35,35,Direct
3525666,125,0,35,295,260,35,35,Direct
3525891,100,0,35,150,115,35,35,Direct
3515463,350,125,50,275,225,50,50,Direct
3525977,50,0,35,170,135,35,35,Direct
3526002,300,75,35,140,105,35,35,Direct
3526041,100,0,35,165,130,35,35,Direct
3526084,50,0,35,165,130,35,35,Direct
3527027,350,115,35,195,160,35,35,Direct
3527088,275,70,75,375,300,75,75,Direct
3527138,150,0,20,95,75,20,20,Direct
3527556,75,0,50,220,170,50,50,Direct
3487521,275,65,35,210,175,35,35,Direct
3487528,275,85,35,205,170,35,35,Direct
3487678,250,35,35,160,125,35,35,Direct
3488307,250,65,20,160,140,20,20,Direct
3488571,400,160,50,325,275,50,50,Direct
3488607,275,45,50,235,185,50,50,Direct
3401517,175,10,35,250,215,35,35,Direct
3489050,250,50,35,140,105,35,35,Direct
3487585,375,135,35,190,155,35,35,Direct
3475253,225,45,35,120,85,35,35,Direct
3489407,250,30,35,180,145,35,35,Direct
3489850,50,0,35,185,150,35,35,Direct
3489950,175,10,35,155,120,35,35,Direct
3490129,100,0,50,220,170,50,50,Direct
3490479,475,195,125,510,385,125,125,Direct
3489743,225,45,50,325,275,50,50,Direct
3490736,200,30,35,165,130,35,35,Direct
3490972,225,25,50,270,220,50,50,Direct
3491279,100,0,20,105,85,20,20,Direct
3491622,250,55,35,170,135,35,35,Direct
3491672,200,15,35,170,135,35,35,Direct
3491772,500,175,50,290,240,50,50,Direct
3491865,125,0,50,210,160,50,50,Direct
3491858,50,0,35,155,120,35,35,Direct
3491965,175,20,50,230,180,50,50,Direct
3492001,75,0,50,225,175,50,50,Direct
3492065,200,20,35,150,115,35,35,Direct
3492151,275,65,35,175,140,35,35,Direct
3492408,200,10,35,170,135,35,35,Direct
3492608,175,15,35,170,135,35,35,Direct
3492694,25,0,20,125,105,20,20,Direct
3492744,100,0,20,110,90,20,20,Direct
3492894,75,0,35,125,90,35,35,Direct
3492908,200,15,20,180,160,20,20,Direct
3492801,250,60,50,250,200,50,50,Direct
3493094,100,0,35,180,145,35,35,Direct
3493144,225,45,35,165,130,35,35,Direct
3493151,75,0,35,140,105,35,35,Direct
3493401,75,0,35,110,75,35,35,Direct
3493594,150,0,50,305,255,50,50,Direct
3493830,75,0,35,245,210,35,35,Direct
3493944,225,25,35,225,190,35,35,Direct
3494023,175,5,35,155,120,35,35,Direct
3494080,225,40,35,170,135,35,35,Direct
3494173,200,40,35,225,190,35,35,Direct
3494373,100,0,50,280,230,50,50,Direct
3494530,125,0,35,245,210,35,35,Direct
3494573,375,155,50,210,160,50,50,Direct
3494616,175,10,50,240,190,50,50,Direct
3494673,175,5,25,65,40,25,25,Direct
3494730,175,10,20,75,55,20,20,Direct
3494973,300,85,20,115,95,20,20,Direct
3495059,200,30,50,200,150,50,50,Direct
3501634,175,15,35,150,115,35,35,Direct
3501741,250,45,35,195,160,35,35,Direct
3501791,250,65,100,250,150,100,100,Direct
3501877,175,10,35,160,125,35,35,Direct
3502127,250,65,50,275,225,50,50,Direct
3502345,225,30,50,295,245,50,50,Direct
3502613,350,100,50,255,205,50,50,Direct
3502638,100,0,35,150,115,35,35,Direct
3502727,150,0,150,300,150,150,150,Direct
3502770,150,0,35,175,140,35,35,Direct
3503170,375,155,50,255,205,50,50,Direct
3503456,125,0,35,225,190,35,35,Direct
3503413,50,0,35,170,135,35,35,Direct
3503574,200,20,50,235,185,50,50,Direct
3503974,225,30,35,125,90,35,35,Direct
3504017,75,0,35,280,245,35,35,Direct
3504131,500,195,55,460,405,55,55,Direct
3504267,150,0,50,275,225,50,50,Direct
3504374,100,0,35,140,105,35,35,Direct
3504417,300,100,35,180,145,35,35,Direct
3504524,100,0,20,180,160,20,20,Direct
3504642,150,0,35,180,145,35,35,Direct
3504792,200,30,35,140,105,35,35,Direct
3504617,175,10,20,160,140,20,20,Direct
3504978,500,220,50,375,325,50,50,Direct
3505335,200,10,50,235,185,50,50,Direct
3505603,175,10,35,180,145,35,35,Direct
3505710,100,0,35,160,125,35,35,Direct
3505553,25,0,50,325,275,50,50,Direct
3505914,250,65,75,300,225,75,75,Direct
3505939,250,50,50,235,185,50,50,Direct
3506114,200,5,35,125,90,35,35,Direct
3506196,125,0,20,170,150,20,20,Direct
3506289,200,15,35,150,115,35,35,Direct
3506357,200,35,35,185,150,35,35,Direct
3506514,425,140,50,275,225,50,50,Direct
3506821,100,0,50,325,275,50,50,Direct
3506939,100,0,35,180,145,35,35,Direct
3507000,225,45,50,285,235,50,50,Direct
3499119,550,265,155,700,545,155,155,Direct
3507400,400,145,150,310,160,150,150,Direct
3504106,100,0,35,155,120,35,35,Direct
3507693,275,85,50,260,210,50,50,Direct
3507718,100,0,35,135,100,35,35,Direct
3507893,175,5,35,135,100,35,35,Direct
3508411,125,0,20,140,120,20,20,Direct
3487197,100,0,35,155,120,35,35,Direct
3487247,125,0,20,160,140,20,20,Direct
3487498,200,30,35,180,145,35,35,Direct
3487848,250,65,75,350,275,75,75,Direct
3487919,250,75,35,165,130,35,35,Direct
3487983,125,0,50,205,155,50,50,Direct
3488119,75,0,35,185,150,35,35,Direct
3488383,425,120,50,240,190,50,50,Direct
3488869,150,0,20,160,140,20,20,Direct
3489137,175,10,25,90,65,25,25,Direct
3486898,125,0,35,225,190,35,35,Direct
3481232,100,0,35,150,115,35,35,Direct
3487180,275,55,35,145,110,35,35,Direct
3489438,250,40,20,180,160,20,20,Direct
3489455,125,0,50,250,200,50,50,Direct
3489587,200,25,20,80,60,20,20,Direct
3489770,325,95,75,355,280,75,75,Direct
3490242,125,0,35,105,70,35,35,Direct
3490255,375,140,20,170,150,20,20,Direct
3490910,125,0,50,250,200,50,50,Direct
3491141,200,10,35,215,180,35,35,Direct
3491392,175,10,20,160,140,20,20,Direct
3491459,175,10,35,160,125,35,35,Direct
3491595,200,25,60,100,40,60,60,Direct
3491660,200,30,35,170,135,35,35,Direct
3491846,275,60,50,290,240,50,50,Direct
3492013,375,150,35,255,220,35,35,Direct
3422757,200,30,20,120,100,20,20,Direct
3426216,125,0,50,285,235,50,50,Direct
3492128,150,0,20,80,60,20,20,Direct
3492196,175,0,35,100,65,35,35,Direct
3490524,50,0,35,245,210,35,35,Direct
3492345,125,0,50,250,200,50,50,Direct
3492077,125,0,35,225,190,35,35,Direct
3492664,200,35,35,105,70,35,35,Direct
3492732,225,50,35,205,170,35,35,Direct
3492745,275,60,58,148,90,58,58,Direct
3492881,100,0,35,285,250,35,35,Direct
3493464,175,5,40,325,285,40,40,Direct
3493481,50,0,20,180,160,20,20,Direct
3493650,100,0,40,230,190,40,40,Direct
3490974,325,130,50,265,215,50,50,Direct
3493799,250,50,50,275,225,50,50,Direct
3493949,150,0,35,155,120,35,35,Direct
3494085,200,10,35,165,130,35,35,Direct
3494417,150,5,20,85,65,20,20,Direct
3494485,450,170,35,245,210,35,35,Direct
3494821,125,0,20,50,30,20,20,Direct
3495186,325,75,35,135,100,35,35,Direct
3495272,450,145,50,275,225,50,50,Direct
3485643,200,15,36,151,115,36,36,Direct
3495386,175,15,35,100,65,35,35,Direct
3518979,75,0,50,230,180,50,50,Direct
3519043,175,15,35,180,145,35,35,Direct
3519160,75,0,35,190,155,35,35,Direct
3519245,175,15,35,140,105,35,35,Direct
3519330,100,0,25,70,45,25,25,Direct
3519594,75,0,35,150,115,35,35,Direct
3486772,375,135,50,235,185,50,50,Direct
3520032,175,15,50,325,275,50,50,Direct
3520081,125,0,20,170,150,20,20,Direct
3520530,125,0,35,225,190,35,35,Direct
3520581,175,10,50,150,100,50,50,Direct
3520615,175,5,35,180,145,35,35,Direct
3520632,175,15,50,220,170,50,50,Direct
3520666,100,0,50,235,185,50,50,Direct
3521081,325,120,40,325,285,40,40,Direct
3520881,100,0,35,185,150,35,35,Direct
3520951,275,75,35,190,155,35,35,Direct
3521017,225,25,35,225,190,35,35,Direct
3521066,125,0,50,260,210,50,50,Direct
3521302,150,0,35,100,65,35,35,Direct
3521402,150,0,35,155,120,35,35,Direct
3522838,200,20,35,180,145,35,35,Direct
3522989,100,0,25,50,25,25,25,Direct
3523004,100,0,35,165,130,35,35,Direct
3523123,150,5,20,100,80,20,20,Direct
3523189,125,0,35,180,145,35,35,Direct
3523404,325,120,40,215,175,40,40,Direct
3523674,50,0,35,165,130,35,35,Direct
3523723,575,250,250,535,285,250,250,Direct
3523923,225,45,20,170,150,20,20,Direct
3510019,175,5,35,155,120,35,35,Direct
3524959,200,15,35,140,105,35,35,Direct
3525095,150,5,35,125,90,35,35,Direct
3525112,225,55,35,245,210,35,35,Direct
3525446,100,0,18,83,65,18,18,Direct
3526046,150,0,50,205,155,50,50,Direct
3526146,75,0,50,220,170,50,50,Direct
3526631,100,0,35,125,90,35,35,Direct
3526646,175,5,35,160,125,35,35,Direct
3526882,200,10,50,275,225,50,50,Direct
3527367,100,0,25,65,40,25,25,Direct
3527582,300,75,50,275,225,50,50,Direct
3526182,125,0,50,230,180,50,50,Direct
3506426,75,0,25,75,50,25,25,Direct
3528454,275,75,50,210,160,50,50,Direct
3528669,25,0,35,250,215,35,35,Direct
3528820,300,100,35,170,135,35,35,Direct
3528854,150,0,50,225,175,50,50,Direct
3528956,125,0,35,190,155,35,35,Direct
3529103,175,15,40,275,235,40,40,Direct
3529239,200,25,35,145,110,35,35,Direct
3529256,75,0,25,85,60,25,25,Direct
3529305,200,20,35,195,160,35,35,Direct
3529356,300,85,35,180,145,35,35,Direct
3529441,225,45,60,195,135,60,60,Direct
3529541,125,0,35,260,225,35,35,Direct
3529490,100,0,60,195,135,60,60,Direct
3529756,175,15,25,80,55,25,25,Direct
3492027,100,0,35,140,105,35,35,Direct
3492160,250,60,35,190,155,35,35,Direct
3492113,125,0,20,170,150,20,20,Direct
3492214,100,0,35,150,115,35,35,Direct
3492445,275,75,35,250,215,35,35,Direct
3492964,200,25,50,200,150,50,50,Direct
3493082,25,0,35,125,90,35,35,Direct
3493031,50,0,20,180,160,20,20,Direct
3493163,250,50,35,195,160,35,35,Direct
3493499,125,0,35,105,70,35,35,Direct
3493567,225,35,60,130,70,60,60,Direct
3493781,175,15,20,180,160,20,20,Direct
3493767,350,100,50,205,155,50,50,Direct
3493882,250,55,35,150,115,35,35,Direct
3493968,175,0,35,285,250,35,35,Direct
3494035,225,40,20,160,140,20,20,Direct
3494049,200,25,50,200,150,50,50,Direct
3494235,350,105,60,190,130,60,60,Direct
3494818,200,20,35,160,125,35,35,Direct
3494653,200,30,35,170,135,35,35,Direct
3491309,125,0,50,225,175,50,50,Direct
3494836,350,100,40,240,200,40,40,Direct
3494903,175,10,50,230,180,50,50,Direct
3495171,175,10,50,250,200,50,50,Direct
3495235,175,15,35,180,145,35,35,Direct
3495253,250,45,50,200,150,50,50,Direct
3495304,325,90,150,350,200,150,150,Direct
3495789,125,0,50,205,155,50,50,Direct
3450933,175,0,25,95,70,25,25,Direct
3495907,225,35,35,130,95,35,35,Direct
3495971,375,120,50,375,325,50,50,Direct
3496040,100,0,35,170,135,35,35,Direct
3496158,400,140,50,275,225,50,50,Direct
3496439,225,30,35,140,105,35,35,Direct
3496507,200,25,50,215,165,50,50,Direct
3496490,150,0,50,225,175,50,50,Direct
3496626,250,45,35,120,85,35,35,Direct
3496707,200,15,20,180,160,20,20,Direct
3496826,150,0,35,150,115,35,35,Direct
3496958,75,0,60,145,85,60,60,Direct
3496976,300,90,35,170,135,35,35,Direct
3497057,200,30,35,245,210,35,35,Direct
3497193,50,0,40,225,185,40,40,Direct
3497494,275,55,35,160,125,35,35,Direct
3497626,375,120,40,230,190,40,40,Direct
3498094,200,30,35,185,150,35,35,Direct
3498494,75,0,35,180,145,35,35,Direct
3498715,150,0,20,160,140,20,20,Direct
3498830,50,0,35,155,120,35,35,Direct
3499065,100,0,20,170,150,20,20,Direct
3496398,75,0,50,275,225,50,50,Direct
3418303,175,10,35,205,170,35,35,Direct
3496547,175,5,50,275,225,50,50,Direct
3496583,250,60,35,255,220,35,35,Direct
3496834,325,95,35,195,160,35,35,Direct
3497000,225,50,50,235,185,50,50,Direct
3497236,200,30,35,165,130,35,35,Direct
3497183,125,0,35,190,155,35,35,Direct
3497419,150,0,50,230,180,50,50,Direct
3497383,200,10,50,225,175,50,50,Direct
3497719,200,25,50,245,195,50,50,Direct
3497821,75,0,35,105,70,35,35,Direct
3497785,75,0,50,220,170,50,50,Direct
3497836,150,0,35,155,120,35,35,Direct
3497936,200,40,50,200,150,50,50,Direct
3497970,50,0,50,250,200,50,50,Direct
3498085,375,135,50,210,160,50,50,Direct
3498321,175,0,45,150,105,45,45,Direct
3498421,200,20,35,285,250,35,35,Direct
3498406,225,45,50,200,150,50,50,Direct
3498821,125,0,20,95,75,20,20,Direct
3499057,225,45,35,165,130,35,35,Direct
3499221,175,15,35,150,115,35,35,Direct
3499308,175,10,20,95,75,20,20,Direct
3499506,300,100,60,180,120,60,60,Direct
3498991,200,25,35,175,140,35,35,Direct
3492705,125,0,20,170,150,20,20,Direct
3477916,100,0,33,113,80,33,33,Direct
3500127,200,30,20,105,85,20,20,Direct
3500444,325,105,50,210,160,50,50,Direct
3500308,250,45,50,220,170,50,50,Direct
3500729,250,50,40,235,195,40,40,Direct
3500978,125,0,35,140,105,35,35,Direct
3500944,100,0,35,250,215,35,35,Direct
3501227,175,15,35,125,90,35,35,Direct
3501380,50,0,35,135,100,35,35,Direct
3501463,150,0,20,80,60,20,20,Direct
3500993,100,0,35,155,120,35,35,Direct
3501965,125,0,20,165,145,20,20,Direct
3501999,75,0,35,135,100,35,35,Direct
3502080,50,0,60,110,50,60,60,Direct
3502350,225,50,35,235,200,35,35,Direct
3502363,300,70,40,225,185,40,40,Direct
3502716,100,0,35,275,240,35,35,Direct
3502950,50,0,20,110,90,20,20,Direct
3503065,375,155,40,285,245,40,40,Direct
3503150,175,15,20,180,160,20,20,Direct
3503299,150,0,35,150,115,35,35,Direct
3503335,125,0,25,75,50,25,25,Direct
3503352,200,25,20,175,155,20,20,Direct
3503450,200,20,35,170,135,35,35,Direct
3498319,225,35,35,180,145,35,35,Direct
3503786,175,15,50,235,185,50,50,Direct
3504035,100,0,50,230,180,50,50,Direct
3529992,225,60,35,185,150,35,35,Direct
3529990,200,20,20,85,65,20,20,Direct
3530056,100,0,35,170,135,35,35,Direct
3530092,300,85,35,190,155,35,35,Direct
3530141,200,35,20,85,65,20,20,Direct
3530256,300,85,50,375,325,50,50,Direct
3530326,175,5,50,240,190,50,50,Direct
3530426,100,0,35,110,75,35,35,Direct
3530526,100,0,35,260,225,35,35,Direct
3530577,200,30,35,190,155,35,35,Direct
3530626,100,0,20,35,15,20,20,Direct
3530775,325,90,50,215,165,50,50,Direct
3530826,200,30,35,145,110,35,35,Direct
3530875,125,0,20,70,50,20,20,Direct
3530877,150,5,20,185,165,20,20,Direct
3530911,100,0,35,100,65,35,35,Direct
3531126,200,15,35,140,105,35,35,Direct
3531177,175,5,50,265,215,50,50,Direct
3531528,250,50,35,150,115,35,35,Direct
3530975,3150,2485,800,3870,3070,800,800,Direct
3532098,75,0,50,235,185,50,50,Direct
3532647,175,15,35,150,115,35,35,Direct
3532800,75,0,20,95,75,20,20,Direct
3532983,125,0,50,225,175,50,50,Direct
3533000,1075,605,250,560,310,250,250,Direct
3533098,150,0,35,155,120,35,35,Direct
3533283,325,90,35,270,235,35,35,Direct
3533585,150,0,35,260,225,35,35,Direct
3533600,100,0,15,80,65,15,15,Direct
3533685,100,0,50,275,225,50,50,Direct
3533936,225,50,75,300,225,75,75,Direct
3534521,200,25,35,295,260,35,35,Direct
3534555,400,215,50,330,280,50,50,Direct
3534585,175,15,20,150,130,20,20,Direct
3534685,175,5,35,180,145,35,35,Direct
3534821,200,25,50,230,180,50,50,Direct
3534872,350,115,75,330,255,75,75,Direct
3534919,225,45,35,170,135,35,35,Direct
3535055,75,0,25,60,35,25,25,Direct
3535406,75,0,35,175,140,35,35,Direct
3535506,50,0,35,250,215,35,35,Direct
3535591,75,0,35,150,115,35,35,Direct
3535721,200,30,35,175,140,35,35,Direct
3536306,100,0,35,170,135,35,35,Direct
3536342,125,0,50,250,200,50,50,Direct
3536527,175,5,40,235,195,40,40,Direct
3536608,150,5,35,115,80,35,35,Direct
3536627,250,50,50,250,200,50,50,Direct
3536644,400,155,35,260,225,35,35,Direct
3537427,75,0,25,50,25,25,25,Direct
3537780,350,85,35,190,155,35,35,Direct
3537980,75,0,35,190,155,35,35,Direct
3520532,200,20,35,155,120,35,35,Direct
3538363,450,140,75,355,280,75,75,Direct
3538863,175,0,35,150,115,35,35,Direct
3539114,200,25,20,160,140,20,20,Direct
3539299,275,80,55,430,375,55,55,Direct
3539316,75,0,35,225,190,35,35,Direct
3539350,175,10,20,135,115,20,20,Direct
3539416,200,25,50,230,180,50,50,Direct
3462286,100,0,35,225,190,35,35,Direct
3479989,225,45,35,115,80,35,35,Direct
3480193,75,0,35,170,135,35,35,Direct
3480368,150,0,35,295,260,35,35,Direct
3480393,200,10,20,195,175,20,20,Direct
3480793,250,55,60,150,90,60,60,Direct
3481295,150,0,35,115,80,35,35,Direct
3481402,200,20,50,270,220,50,50,Direct
3481427,125,0,35,100,65,35,35,Direct
3481627,100,0,35,165,130,35,35,Direct
3481661,100,0,60,190,130,60,60,Direct
3481895,175,10,35,170,135,35,35,Direct
3482006,200,20,35,130,95,35,35,Direct
3482040,150,0,25,95,70,25,25,Direct
3474407,250,55,35,140,105,35,35,Direct
3482240,25,0,35,175,140,35,35,Direct
3482772,225,45,35,155,120,35,35,Direct
3460805,200,30,35,155,120,35,35,Direct
3464392,225,40,35,195,160,35,35,Direct
3483235,125,0,35,125,90,35,35,Direct
3483274,200,30,55,425,370,55,55,Direct
3483299,175,10,35,105,70,35,35,Direct
3483401,175,10,50,275,225,50,50,Direct
3483912,150,0,35,160,125,35,35,Direct
3484269,225,45,35,180,145,35,35,Direct
3484469,200,20,35,245,210,35,35,Direct
3484376,175,20,50,250,200,50,50,Direct
3484771,250,55,35,170,135,35,35,Direct
3484903,150,0,20,75,55,20,20,Direct
3485112,375,130,20,165,145,20,20,Direct
3485273,75,0,37,182,145,37,37,Direct
3485171,175,5,50,230,180,50,50,Direct
3485439,400,175,110,430,320,110,110,Direct
3485546,150,0,35,180,145,35,35,Direct
3485648,175,0,50,200,150,50,50,Direct
3485882,275,80,35,170,135,35,35,Direct
3485975,225,50,50,200,150,50,50,Direct
3486048,125,0,35,170,135,35,35,Direct
3486184,150,0,25,95,70,25,25,Direct
3486375,25,0,20,130,110,20,20,Direct
3486409,225,55,35,145,110,35,35,Direct
3486609,175,0,40,220,180,40,40,Direct
3478360,175,0,35,180,145,35,35,Direct
3486784,175,10,35,115,80,35,35,Direct
3487052,100,0,35,290,255,35,35,Direct
3487345,50,0,35,140,105,35,35,Direct
3487379,225,45,20,170,150,20,20,Direct
3487686,325,100,50,275,225,50,50,Direct
3488115,175,15,50,205,155,50,50,Direct
3488413,200,35,60,130,70,60,60,Direct
3488456,125,0,35,245,210,35,35,Direct
3501403,25,0,20,80,60,20,20,Direct
3501653,325,110,50,250,200,50,50,Direct
3501840,250,40,35,190,155,35,35,Direct
3480248,175,10,25,90,65,25,25,Direct
3502490,150,0,40,210,170,40,40,Direct
3502540,300,85,35,160,125,35,35,Direct
3502639,150,0,35,215,180,35,35,Direct
3502725,125,0,35,125,90,35,35,Direct
3502739,75,0,35,150,115,35,35,Direct
3503090,400,140,75,325,250,75,75,Direct
3503275,175,5,35,150,115,35,35,Direct
3503426,125,0,35,160,125,35,35,Direct
3502640,175,0,35,180,145,35,35,Direct
3470637,75,0,35,170,135,35,35,Direct
3465858,100,0,35,170,135,35,35,Direct
3503961,75,0,35,135,100,35,35,Direct
3504012,175,10,20,180,160,20,20,Direct
3504111,175,15,50,210,160,50,50,Direct
3504161,325,120,50,245,195,50,50,Direct
3504311,75,0,35,155,120,35,35,Direct
3504262,200,15,35,175,140,35,35,Direct
3504312,625,250,50,325,275,50,50,Direct
3504512,250,60,40,265,225,40,40,Direct
3504612,200,10,50,235,185,50,50,Direct
3504598,75,0,50,250,200,50,50,Direct
3504962,375,150,49,209,160,49,49,Direct
3505233,100,0,20,130,110,20,20,Direct
3505648,125,0,20,160,140,20,20,Direct
3505697,275,65,20,140,120,20,20,Direct
3505748,175,15,50,250,200,50,50,Direct
3506134,50,0,20,85,65,20,20,Direct
3506169,75,0,35,150,115,35,35,Direct
3506720,175,10,35,115,80,35,35,Direct
3506819,225,35,50,240,190,50,50,Direct
3507070,150,0,50,215,165,50,50,Direct
3459941,25,0,60,195,135,60,60,Direct
3505533,75,0,20,140,120,20,20,Direct
3505333,175,10,35,195,160,35,35,Direct
3491444,200,25,35,175,140,35,35,Direct
3489621,100,0,40,110,50,60,60,Direct
3507820,75,0,35,190,155,35,35,Direct
3508942,375,120,35,250,215,35,35,Direct
3509006,25,0,35,250,215,35,35,Direct
3509042,250,60,35,180,145,35,35,Direct
3509291,250,55,50,265,215,50,50,Direct
3509628,125,0,35,155,120,35,35,Direct
3510128,325,95,50,285,235,50,50,Direct
3510177,75,0,50,210,160,50,50,Direct
3504188,350,110,75,285,210,75,75,Direct
3504371,125,0,35,155,120,35,35,Direct
3504522,200,25,35,165,130,35,35,Direct
3504622,100,0,35,105,70,35,35,Direct
3505407,300,75,60,155,95,60,60,Direct
3505524,275,75,60,120,60,60,60,Direct
3505622,100,0,35,100,65,35,35,Direct
3505609,275,60,35,155,120,35,35,Direct
3505707,275,65,35,150,115,35,35,Direct
3477614,175,10,35,160,125,35,35,Direct
3506060,300,55,35,150,115,35,35,Direct
3506160,300,70,35,150,115,35,35,Direct
3506424,150,0,20,30,10,20,20,Direct
3506460,300,75,50,210,160,50,50,Direct
3507360,100,0,50,250,200,50,50,Direct
3507230,375,150,20,180,160,20,20,Direct
3507494,175,10,50,245,195,50,50,Direct
3507915,125,0,35,135,100,35,35,Direct
3507932,175,5,60,150,90,60,60,Direct
3508166,150,0,35,160,125,35,35,Direct
3508279,325,85,35,170,135,35,35,Direct
3508415,225,60,75,375,300,75,75,Direct
3508430,150,0,25,70,45,25,25,Direct
3508515,200,20,35,155,120,35,35,Direct
3508630,50,0,35,145,110,35,35,Direct
3508851,925,520,370,900,530,370,370,Direct
3509017,150,0,35,175,140,35,35,Direct
3509502,175,10,25,60,35,25,25,Direct
3509751,125,0,20,95,75,20,20,Direct
3501544,250,65,20,110,90,20,20,Direct
3510004,75,0,40,250,210,40,40,Direct
3510102,100,0,20,140,120,20,20,Direct
3510138,50,0,35,170,135,35,35,Direct
3510151,175,5,20,180,160,20,20,Direct
3509668,100,0,35,260,225,35,35,Direct
3510687,200,30,35,150,115,35,35,Direct
3510887,175,10,50,275,225,50,50,Direct
3510923,100,0,35,170,135,35,35,Direct
3511087,375,150,50,275,225,50,50,Direct
3511304,250,30,20,90,70,20,20,Direct
3511289,300,90,75,385,310,75,75,Direct
3511689,150,0,35,115,80,35,35,Direct
3511776,175,5,20,35,15,20,20,Direct
3511789,250,25,50,375,325,50,50,Direct
3511974,75,0,20,140,120,20,20,Direct
3511959,225,35,40,325,285,40,40,Direct
3512074,225,25,20,155,135,20,20,Direct
3512325,375,140,75,330,255,75,75,Direct
3512376,425,140,50,275,225,50,50,Direct
3512710,150,0,20,65,45,20,20,Direct
3512761,125,0,35,225,190,35,35,Direct
3513312,100,0,35,100,65,35,35,Direct
3513461,75,0,35,180,145,35,35,Direct
3490748,100,0,20,85,65,20,20,Direct
3513761,100,0,35,190,155,35,35,Direct
3539450,175,10,20,140,120,20,20,Direct
3539516,275,60,35,190,155,35,35,Direct
3539750,125,0,35,140,105,35,35,Direct
3539916,225,45,35,180,145,35,35,Direct
3540150,175,10,35,155,120,35,35,Direct
3540486,250,45,50,325,275,50,50,Direct
3540601,175,10,50,250,200,50,50,Direct
3540722,225,30,35,180,145,35,35,Direct
3540737,200,30,35,210,175,35,35,Direct
3532449,200,30,35,185,150,35,35,Direct
3541173,175,10,35,255,220,35,35,Direct
3541186,175,10,40,325,285,40,40,Direct
3541671,225,45,35,275,240,35,35,Direct
3541724,400,140,40,205,165,40,40,Direct
3526831,200,30,35,265,230,35,35,Direct
3541888,125,0,35,170,135,35,35,Direct
3541922,200,35,35,190,155,35,35,Direct
3542073,225,35,40,255,215,40,40,Direct
3542424,900,505,400,1085,685,400,400,Direct
3542558,100,0,35,200,165,35,35,Direct
3542560,275,65,35,180,145,35,35,Direct
3542709,250,65,20,160,140,20,20,Direct
3542860,300,75,38,218,180,38,38,Direct
3542994,175,0,35,150,115,35,35,Direct
3543309,150,5,35,140,105,35,35,Direct
3543594,175,5,50,240,190,50,50,Direct
3543760,350,120,75,365,290,75,75,Direct
3543779,125,0,35,150,115,35,35,Direct
3543994,100,0,35,125,90,35,35,Direct
3544081,325,110,75,380,305,75,75,Direct
3544079,150,0,50,225,175,50,50,Direct
3544445,175,10,50,275,225,50,50,Direct
3544515,175,5,35,160,125,35,35,Direct
3544630,100,0,35,180,145,35,35,Direct
3544732,75,0,35,125,90,35,35,Direct
3544781,75,0,25,65,40,25,25,Direct
3545266,175,10,35,180,145,35,35,Direct
3545415,225,30,35,225,190,35,35,Direct
3545566,75,0,20,65,45,20,20,Direct
3545702,125,0,20,95,75,20,20,Direct
3545768,125,0,35,175,140,35,35,Direct
3546017,225,45,35,155,120,35,35,Direct
3546002,175,15,35,210,175,35,35,Direct
3546268,250,0,35,115,80,35,35,Direct
3546304,350,135,35,195,160,35,35,Direct
3546404,200,25,50,205,155,50,50,Direct
3546451,75,0,20,75,55,20,20,Direct
3546604,125,0,35,100,65,35,35,Direct
3546587,200,20,35,185,150,35,35,Direct
3546738,250,65,35,160,125,35,35,Direct
3546802,125,0,35,155,120,35,35,Direct
3547004,75,0,50,205,155,50,50,Direct
3547438,50,0,35,125,90,35,35,Direct
3547538,175,0,20,160,140,20,20,Direct
3547640,125,0,25,95,70,25,25,Direct
3547940,125,0,50,200,150,50,50,Direct
3548289,100,0,50,205,155,50,50,Direct
3548559,150,0,35,180,145,35,35,Direct
3548774,225,35,25,90,65,25,25,Direct
3533900,75,0,20,40,20,20,20,Direct
3478176,100,0,35,150,115,35,35,Direct
3478203,275,70,50,235,185,50,50,Direct
3478269,175,5,20,80,60,20,20,Direct
3478403,75,0,50,220,170,50,50,Direct
3478512,250,60,40,250,210,40,40,Direct
3478612,300,90,50,225,175,50,50,Direct
3478712,150,0,50,330,280,50,50,Direct
3478746,100,0,50,245,195,50,50,Direct
3479048,25,0,35,155,120,35,35,Direct
3479282,200,35,35,190,155,35,35,Direct
3479441,150,5,35,110,75,35,35,Direct
3479739,200,25,35,240,205,35,35,Direct
3479839,75,0,35,150,115,35,35,Direct
3479941,325,100,50,200,150,50,50,Direct
3480118,175,25,50,225,175,50,50,Direct
3480475,225,45,20,165,145,20,20,Direct
3480484,300,80,20,150,130,20,20,Direct
3480575,275,60,35,290,255,35,35,Direct
3480977,225,25,35,225,190,35,35,Direct
3481020,125,0,35,130,95,35,35,Direct
3481377,200,30,35,195,160,35,35,Direct
3481447,100,0,35,165,130,35,35,Direct
3481513,175,20,60,195,135,60,60,Direct
3481547,225,30,100,200,100,100,100,Direct
3481613,400,155,45,390,345,45,45,Direct
3482020,75,0,35,280,245,35,35,Direct
3482090,125,0,35,125,90,35,35,Direct
3482354,300,85,35,180,145,35,35,Direct
3467316,225,25,35,180,145,35,35,Direct
3483190,225,25,50,230,180,50,50,Direct
3483349,175,0,35,145,110,35,35,Direct
3483449,150,5,50,290,240,50,50,Direct
3483519,225,40,35,175,140,35,35,Direct
3483862,175,10,35,190,155,35,35,Direct
3484462,225,45,35,190,155,35,35,Direct
3484719,125,0,35,125,90,35,35,Direct
3485121,325,85,35,175,140,35,35,Direct
3485064,325,160,50,290,240,50,50,Direct
3485098,100,0,20,45,25,20,20,Direct
3485298,200,25,35,105,70,35,35,Direct
3485521,125,0,50,220,170,50,50,Direct
3485591,200,40,20,65,45,20,20,Direct
3485764,200,0,75,310,235,75,75,Direct
3486200,325,85,35,145,110,35,35,Direct
3516034,175,0,35,255,220,35,35,Direct
3516187,150,0,35,190,155,35,35,Direct
3510737,100,0,60,195,135,60,60,Direct
3516719,250,40,50,230,180,50,50,Direct
3516889,300,80,35,185,150,35,35,Direct
3516804,200,30,50,205,155,50,50,Direct
3517106,75,0,20,80,60,20,20,Direct
3517157,250,40,20,170,150,20,20,Direct
3517221,50,0,35,180,145,35,35,Direct
3517340,200,30,35,190,155,35,35,Direct
3518042,150,0,50,260,210,50,50,Direct
3517906,100,0,25,50,25,25,25,Direct
3517957,200,30,50,240,190,50,50,Direct
3518123,225,40,35,150,115,35,35,Direct
3518259,125,0,35,265,230,35,35,Direct
3518391,200,20,33,118,85,33,33,Direct
3518510,175,5,20,35,15,20,20,Direct
3518676,300,115,35,230,195,35,35,Direct
3518808,275,85,35,190,155,35,35,Direct
3518812,175,5,50,275,225,50,50,Direct
3519042,175,20,35,160,125,35,35,Direct
3519093,400,160,35,290,255,35,35,Direct
3519510,75,0,50,260,210,50,50,Direct
3520429,250,50,50,275,225,50,50,Direct
3520565,175,15,35,180,145,35,35,Direct
3520731,225,45,20,95,75,20,20,Direct
3521399,150,0,35,285,250,35,35,Direct
3521518,200,20,20,170,150,20,20,Direct
3521986,50,0,20,75,55,20,20,Direct
3521952,75,0,35,175,140,35,35,Direct
3522118,50,0,35,100,65,35,35,Direct
3522152,100,0,20,40,20,20,20,Direct
3522237,175,5,10,20,10,10,10,Direct
3522654,175,10,20,170,150,20,20,Direct
3522752,125,0,35,260,225,35,35,Direct
3523054,300,70,50,220,170,50,50,Direct
3523156,150,5,20,170,150,20,20,Direct
3523390,350,125,35,260,225,35,35,Direct
3523692,1175,715,450,1245,795,450,450,Direct
3523790,200,25,60,135,75,60,60,Direct
3523858,375,140,35,235,200,35,35,Direct
3523990,175,0,20,180,160,20,20,Direct
3524024,275,70,40,250,210,40,40,Direct
3524156,250,50,50,235,185,50,50,Direct
3524173,300,140,50,245,195,50,50,Direct
3524224,175,10,35,150,115,35,35,Direct
3512324,200,30,40,240,200,40,40,Direct
3524326,100,0,35,170,135,35,35,Direct
3524390,300,70,55,300,245,55,55,Direct
3523427,125,0,35,150,115,35,35,Direct
3523770,200,15,20,70,50,20,20,Direct
3510866,300,65,50,275,225,50,50,Direct
3514410,175,10,20,90,70,20,20,Direct
3524072,100,0,35,260,225,35,35,Direct
3524363,200,30,35,155,120,35,35,Direct
3524572,150,0,35,190,155,35,35,Direct
3524665,200,30,50,375,325,50,50,Direct
3524806,175,10,35,140,105,35,35,Direct
3525099,150,0,35,225,190,35,35,Direct
3525242,350,120,50,235,185,50,50,Direct
3525306,250,55,35,100,65,35,35,Direct
3525506,175,15,20,85,65,20,20,Direct
3525542,100,0,20,35,15,20,20,Direct
3525065,250,45,40,265,225,40,40,Direct
3525701,200,30,35,115,80,35,35,Direct
3525999,25,0,35,190,155,35,35,Direct
3526671,100,0,35,255,220,35,35,Direct
3526878,125,0,35,185,150,35,35,Direct
3526935,475,165,75,375,300,75,75,Direct
3527380,50,0,35,120,85,35,35,Direct
3527614,175,10,35,195,160,35,35,Direct
3527637,175,0,20,125,105,20,20,Direct
3527780,250,40,35,290,255,35,35,Direct
3527873,250,65,35,250,215,35,35,Direct
3526978,375,120,40,220,180,40,40,Direct
3528316,200,35,40,355,315,40,40,Direct
3528314,125,0,50,215,165,50,50,Direct
3528643,125,0,50,230,180,50,50,Direct
3528950,300,75,50,260,210,50,50,Direct
3529579,225,15,35,150,115,35,35,Direct
3529743,250,45,23,93,70,23,23,Direct
3529786,100,0,35,210,175,35,35,Direct
3530079,75,0,50,235,185,50,50,Direct
3530122,250,55,35,250,215,35,35,Direct
3530186,350,105,50,325,275,50,50,Direct
3530279,50,0,25,95,70,25,25,Direct
3530479,150,0,35,175,140,35,35,Direct
3530645,100,0,25,75,50,25,25,Direct
3530679,250,50,50,235,185,50,50,Direct
3530924,250,65,35,150,115,35,35,Direct
3531022,100,0,20,165,145,20,20,Direct
3530981,75,0,20,170,150,20,20,Direct
3531081,200,20,75,305,230,75,75,Direct
3531415,125,0,50,220,170,50,50,Direct
3531558,275,60,35,160,125,35,35,Direct
3531758,750,470,340,890,550,340,340,Direct
3531760,250,45,50,235,185,50,50,Direct
3514869,225,25,35,155,120,35,35,Direct
3532160,100,0,60,120,60,60,60,Direct
3532360,175,10,50,275,225,50,50,Direct
3532553,100,0,35,190,155,35,35,Direct
3511103,100,0,50,230,180,50,50,Direct
3511260,300,60,50,200,150,50,50,Direct
3511317,150,0,35,170,135,35,35,Direct
3511360,175,10,50,250,200,50,50,Direct
3511417,150,0,35,190,155,35,35,Direct
3511503,175,5,35,175,140,35,35,Direct
3510224,250,40,35,255,220,35,35,Direct
3511646,100,0,35,225,190,35,35,Direct
3511703,225,55,35,125,90,35,35,Direct
3512439,325,75,50,260,210,50,50,Direct
3512546,50,0,35,150,115,35,35,Direct
3472763,450,140,50,230,180,50,50,Direct
3512846,225,45,35,150,115,35,35,Direct
3513039,225,45,35,225,190,35,35,Direct
3513282,125,0,35,135,100,35,35,Direct
3513432,300,100,50,285,235,50,50,Direct
3513568,50,0,35,155,120,35,35,Direct
3513682,150,0,35,225,190,35,35,Direct
3513775,150,5,35,250,215,35,35,Direct
3514168,100,0,35,100,65,35,35,Direct
3514225,275,50,20,95,75,20,20,Direct
3514275,175,5,50,280,230,50,50,Direct
3514404,50,0,35,160,125,35,35,Direct
3514754,250,50,35,185,150,35,35,Direct
3514811,75,0,25,50,25,25,25,Direct
3514961,200,15,50,230,180,50,50,Direct
3515197,275,65,50,235,185,50,50,Direct
3497106,275,80,35,155,120,35,35,Direct
3515540,175,10,50,210,160,50,50,Direct
3515697,225,60,75,390,315,75,75,Direct
3515747,175,10,35,195,160,35,35,Direct
3515754,325,105,50,280,230,50,50,Direct
3515797,125,0,35,190,155,35,35,Direct
3515890,175,10,50,225,175,50,50,Direct
3516147,150,0,40,205,165,40,40,Direct
3516183,175,5,50,275,225,50,50,Direct
3516347,350,90,35,155,120,35,35,Direct
3516426,200,25,20,80,60,20,20,Direct
3516526,250,50,100,230,130,100,100,Direct
3516540,250,65,35,270,235,35,35,Direct
3516776,250,45,50,275,225,50,50,Direct
3516933,100,0,20,160,140,20,20,Direct
3516969,175,10,20,185,165,20,20,Direct
3516983,175,5,35,165,130,35,35,Direct
3517019,175,10,35,150,115,35,35,Direct
3517183,250,55,35,150,115,35,35,Direct
3517412,225,45,20,100,80,20,20,Direct
3517462,225,35,50,230,180,50,50,Direct
3517562,200,10,35,145,110,35,35,Direct
3517612,475,160,50,260,210,50,50,Direct
3549461,275,65,35,155,120,35,35,Direct
3549676,125,0,35,160,125,35,35,Direct
3549912,200,10,35,175,140,35,35,Direct
3550361,175,0,20,150,130,20,20,Direct
3550297,125,0,50,270,220,50,50,Direct
3550448,75,0,35,185,150,35,35,Direct
3549997,225,45,35,190,155,35,35,Direct
3550631,150,0,35,150,115,35,35,Direct
3551682,75,0,35,150,115,35,35,Direct
3551869,150,0,20,190,170,20,20,Direct
3552103,175,5,20,140,120,20,20,Direct
3552269,275,75,35,210,175,35,35,Direct
3552369,150,0,20,75,55,20,20,Direct
3552554,250,65,50,205,155,50,50,Direct
3541371,75,0,35,145,110,35,35,Direct
3553005,75,0,35,190,155,35,35,Direct
3553239,325,105,20,170,150,20,20,Direct
3553320,75,0,35,125,90,35,35,Direct
3553403,225,30,40,240,200,40,40,Direct
3554075,250,50,35,190,155,35,35,Direct
3554090,325,105,35,190,155,35,35,Direct
3554475,175,5,25,75,50,25,25,Direct
3554556,100,0,35,175,140,35,35,Direct
3554741,175,10,35,175,140,35,35,Direct
3554992,25,0,35,115,80,35,35,Direct
3555111,100,0,35,100,65,35,35,Direct
3555311,150,0,40,240,200,40,40,Direct
3555428,200,15,50,275,225,50,50,Direct
3555626,75,0,35,170,135,35,35,Direct
3556564,100,0,15,40,25,15,15,Direct
3554141,175,10,35,145,110,35,35,Direct
3556047,225,50,22,97,75,22,22,Direct
3556849,125,0,35,135,100,35,35,Direct
3554777,225,35,35,170,135,35,35,Direct
3557298,175,20,20,70,50,20,20,Direct
3557883,50,0,35,180,145,35,35,Direct
3558083,325,120,50,250,200,50,50,Direct
3558136,100,0,35,115,80,35,35,Direct
3557783,100,0,50,275,225,50,50,Direct
3558219,75,0,35,170,135,35,35,Direct
3558736,100,0,35,185,150,35,35,Direct
3558785,200,30,35,150,115,35,35,Direct
3559070,150,0,35,135,100,35,35,Direct
3559757,100,0,20,25,5,20,20,Direct
3559872,225,30,35,175,140,35,35,Direct
3559906,75,0,25,50,25,25,25,Direct
3559955,100,0,35,150,115,35,35,Direct
3560257,100,0,35,170,135,35,35,Direct
3538516,175,10,35,175,140,35,35,Direct
3560742,75,0,20,180,160,20,20,Direct
3561293,125,0,35,120,85,35,35,Direct
3532896,325,105,35,230,195,35,35,Direct
3532996,375,125,50,275,225,50,50,Direct
3533053,200,25,40,210,170,40,40,Direct
3533253,100,0,20,140,120,20,20,Direct
3533530,175,5,35,165,130,35,35,Direct
3533789,300,90,50,250,200,50,50,Direct
3533830,125,0,4,9,5,4,4,Direct
3533930,150,5,24,99,75,24,24,Direct
3534030,200,20,50,200,150,50,50,Direct
3534332,225,40,40,250,210,40,40,Direct
3534725,50,0,40,240,200,40,40,Direct
3535025,25,0,25,90,65,25,25,Direct
3535359,175,10,35,150,115,35,35,Direct
3517184,75,0,35,150,115,35,35,Direct
3535695,350,100,35,190,155,35,35,Direct
3535704,225,45,50,250,200,50,50,Direct
3535795,75,0,50,375,325,50,50,Direct
3535804,150,5,35,150,115,35,35,Direct
3535938,75,0,50,275,225,50,50,Direct
3536095,225,45,35,175,140,35,35,Direct
3536104,50,0,35,230,195,35,35,Direct
3536161,150,0,50,350,300,50,50,Direct
3536204,200,30,35,125,90,35,35,Direct
3536295,200,30,35,190,155,35,35,Direct
3536297,150,0,35,160,125,35,35,Direct
3536304,100,0,35,105,70,35,35,Direct
3536504,125,0,35,140,105,35,35,Direct
3536597,100,0,35,155,120,35,35,Direct
3536638,450,145,35,190,155,35,35,Direct
3536631,175,20,35,125,90,35,35,Direct
3536740,250,55,35,180,145,35,35,Direct
3538476,225,45,35,275,240,35,35,Direct
3538603,175,5,35,150,115,35,35,Direct
3538846,175,15,35,150,115,35,35,Direct
3539169,175,0,35,170,135,35,35,Direct
3539369,275,65,20,130,110,20,20,Direct
3539912,175,10,35,185,150,35,35,Direct
3539603,200,25,50,265,215,50,50,Direct
3540146,200,15,50,275,225,50,50,Direct
3531658,275,65,35,150,115,35,35,Direct
3518156,100,0,35,125,90,35,35,Direct
3540439,300,70,35,175,140,35,35,Direct
3540482,350,115,35,170,135,35,35,Direct
3540639,525,245,75,350,275,75,75,Direct
3540575,100,0,50,325,275,50,50,Direct
3540948,125,0,50,185,135,50,50,Direct
3540941,275,65,50,250,200,50,50,Direct
3541018,50,0,40,240,200,40,40,Direct
3541318,175,5,50,300,250,50,50,Direct
3541411,100,0,35,175,140,35,35,Direct
3541477,100,0,35,225,190,35,35,Direct
3541511,175,20,60,110,50,60,60,Direct
3541520,125,0,50,235,185,50,50,Direct
3541777,225,45,35,200,165,35,35,Direct
3541920,225,50,110,410,300,110,110,Direct
3542054,150,0,35,235,200,35,35,Direct
3534166,250,25,35,125,90,35,35,Direct
3498762,175,10,20,160,140,20,20,Direct
3499248,200,30,35,135,100,35,35,Direct
3499447,200,15,35,225,190,35,35,Direct
3498044,225,30,20,140,120,20,20,Direct
3499916,225,45,35,175,140,35,35,Direct
3499933,275,75,50,230,180,50,50,Direct
3500133,50,0,35,190,155,35,35,Direct
3500302,100,0,35,180,145,35,35,Direct
3500319,175,5,35,155,120,35,35,Direct
3500383,250,60,35,180,145,35,35,Direct
3500720,125,0,20,75,55,20,20,Direct
3500801,50,0,35,115,80,35,35,Direct
3500902,200,30,35,165,130,35,35,Direct
3501069,275,65,50,225,175,50,50,Direct
3501119,175,10,50,220,170,50,50,Direct
3501137,175,15,50,250,200,50,50,Direct
3501388,0,0,15,40,25,15,15,Direct
3501655,225,30,20,75,55,20,20,Direct
3501737,75,0,20,80,60,20,20,Direct
3501856,325,115,35,160,125,35,35,Direct
3501873,25,0,50,275,225,50,50,Direct
3497979,125,0,20,130,110,20,20,Direct
3502256,225,40,35,185,150,35,35,Direct
3502792,100,0,50,210,160,50,50,Direct
3502856,50,0,35,170,135,35,35,Direct
3502941,200,25,20,65,45,20,20,Direct
3502992,100,0,20,140,120,20,20,Direct
3503042,525,215,50,375,325,50,50,Direct
3503059,100,0,20,80,60,20,20,Direct
3503545,150,0,35,180,145,35,35,Direct
3503927,375,135,50,240,190,50,50,Direct
3503978,200,25,20,110,90,20,20,Direct
3504009,225,35,50,235,185,50,50,Direct
3504310,100,0,50,200,150,50,50,Direct
3504396,200,30,75,300,225,75,75,Direct
3504531,75,0,35,140,105,35,35,Direct
3504596,75,0,35,120,85,35,35,Direct
3427834,375,120,35,180,145,35,35,Direct
3504995,400,135,50,285,235,50,50,Direct
3504914,250,40,35,225,190,35,35,Direct
3505063,25,0,20,175,155,20,20,Direct
3505182,275,70,35,150,115,35,35,Direct
3505464,125,0,35,100,65,35,35,Direct
3505732,150,0,60,135,75,60,60,Direct
3505881,175,10,35,155,120,35,35,Direct
3505932,100,0,20,140,120,20,20,Direct
3505935,75,0,20,65,45,20,20,Direct
3506149,75,0,35,155,120,35,35,Direct
3488817,250,40,50,200,150,50,50,Direct
3488856,175,10,20,170,150,20,20,Direct
3488890,150,0,35,175,140,35,35,Direct
3488924,200,25,25,80,55,25,25,Direct
3488090,350,135,35,245,210,35,35,Direct
3489217,275,65,35,170,135,35,35,Direct
3489226,350,115,50,275,225,50,50,Direct
3489349,250,45,35,150,115,35,35,Direct
3489617,75,0,50,340,290,50,50,Direct
3489719,325,95,50,290,240,50,50,Direct
3488315,500,195,50,295,245,50,50,Direct
3490192,200,30,20,170,150,20,20,Direct
3490596,300,105,35,185,150,35,35,Direct
3490919,150,5,35,215,180,35,35,Direct
3489324,225,60,35,240,205,35,35,Direct
3480125,225,35,35,225,190,35,35,Direct
3464158,125,0,35,190,155,35,35,Direct
3491153,225,45,50,260,210,50,50,Direct
3491157,100,0,20,180,160,20,20,Direct
3491387,250,65,35,180,145,35,35,Direct
3491464,150,0,35,145,110,35,35,Direct
3491689,200,25,50,225,175,50,50,Direct
3491757,175,10,35,170,135,35,35,Direct
3491800,100,0,35,150,115,35,35,Direct
3491855,200,20,35,115,80,35,35,Direct
3491889,225,35,20,170,150,20,20,Direct
3481929,200,30,35,185,150,35,35,Direct
3492089,175,10,25,70,45,25,25,Direct
3492157,125,0,35,190,155,35,35,Direct
3492298,175,10,25,95,70,25,25,Direct
3492332,175,5,35,160,125,35,35,Direct
3492400,175,5,40,325,285,40,40,Direct
3492468,75,0,20,170,150,20,20,Direct
3492557,500,220,35,285,250,35,35,Direct
3492702,100,0,20,165,145,20,20,Direct
3493059,100,0,20,135,115,20,20,Direct
3493068,100,0,33,138,105,33,33,Direct
3493102,125,0,35,225,190,35,35,Direct
3493093,300,100,75,395,320,75,75,Direct
3493000,175,5,35,125,90,35,35,Direct
3493170,50,0,40,220,180,40,40,Direct
3493259,200,25,50,245,195,50,50,Direct
3493770,175,10,50,230,180,50,50,Direct
3493829,275,60,20,145,125,20,20,Direct
3493936,175,15,20,180,160,20,20,Direct
3494165,225,15,20,170,150,20,20,Direct
3494170,175,10,50,275,225,50,50,Direct
3494263,25,0,35,100,65,35,35,Direct
3494306,225,30,35,290,255,35,35,Direct
3494540,200,5,35,170,135,35,35,Direct
3542511,175,20,20,160,140,20,20,Direct
3542154,150,5,35,170,135,35,35,Direct
3542656,250,65,35,150,115,35,35,Direct
3542920,100,0,20,65,45,20,20,Direct
3543047,125,0,35,245,210,35,35,Direct
3543256,100,0,35,165,130,35,35,Direct
3543692,200,25,19,84,65,19,19,Direct
3543826,225,35,35,140,105,35,35,Direct
3543883,175,10,20,170,150,20,20,Direct
3543990,275,60,35,145,110,35,35,Direct
3544092,175,10,60,110,50,60,60,Direct
3544249,175,10,25,95,70,25,25,Direct
3544626,75,0,20,140,120,20,20,Direct
3544728,200,15,35,225,190,35,35,Direct
3544892,350,140,35,200,165,35,35,Direct
3544192,225,35,35,275,240,35,35,Direct
3545285,100,0,20,85,65,20,20,Direct
3545362,175,20,35,150,115,35,35,Direct
3545428,225,45,60,165,105,60,60,Direct
3545464,225,30,35,225,190,35,35,Direct
3545621,125,0,35,165,130,35,35,Direct
3545762,300,95,50,210,160,50,50,Direct
3546162,175,0,25,50,25,25,25,Direct
3546221,225,35,35,150,115,35,35,Direct
3546264,75,0,35,185,150,35,35,Direct
3546355,175,10,50,315,265,50,50,Direct
3546498,275,50,20,150,130,20,20,Direct
3546491,200,15,50,205,155,50,50,Direct
3546655,550,240,55,460,405,55,55,Direct
3546764,175,0,35,150,115,35,35,Direct
3546893,175,10,35,160,125,35,35,Direct
3546900,50,0,20,130,110,20,20,Direct
3546957,250,50,50,310,260,50,50,Direct
3547091,100,0,35,140,105,35,35,Direct
3547534,100,0,35,160,125,35,35,Direct
3547634,125,0,35,150,115,35,35,Direct
3547934,250,65,50,200,150,50,50,Direct
3548027,100,0,25,85,60,25,25,Direct
3548129,100,0,35,100,65,35,35,Direct
3548136,100,0,35,160,125,35,35,Direct
3548193,200,20,75,315,240,75,75,Direct
3548436,150,0,50,275,225,50,50,Direct
3548529,125,0,25,95,70,25,25,Direct
3548563,200,35,50,220,170,50,50,Direct
3548606,50,0,35,160,125,35,35,Direct
3548672,200,20,35,150,115,35,35,Direct
3548972,275,80,50,275,225,50,50,Direct
3526142,175,0,35,160,125,35,35,Direct
3549606,175,5,50,240,190,50,50,Direct
3549642,250,40,35,150,115,35,35,Direct
3549801,475,190,50,250,200,50,50,Direct
3549906,175,5,50,250,200,50,50,Direct
3550201,175,15,50,205,155,50,50,Direct
3550242,225,35,35,185,150,35,35,Direct
3550308,300,85,50,200,150,50,50,Direct
3550301,400,170,50,375,325,50,50,Direct
3550742,100,0,35,175,140,35,35,Direct
3550737,150,5,35,140,105,35,35,Direct
3550878,125,0,35,160,125,35,35,Direct
3550935,125,0,25,70,45,25,25,Direct
3551001,225,40,50,225,175,50,50,Direct
3551478,200,30,35,240,205,35,35,Direct
3551578,375,150,40,220,180,40,40,Direct
3528099,125,0,35,125,90,35,35,Direct
3527495,225,35,20,135,115,20,20,Direct
3528406,175,0,35,165,130,35,35,Direct
3528424,75,0,35,125,90,35,35,Direct
3528492,50,0,35,225,190,35,35,Direct
3528760,50,0,20,45,25,20,20,Direct
3528785,325,90,75,335,260,75,75,Direct
3528899,250,50,35,100,65,35,35,Direct
3529024,200,30,50,250,200,50,50,Direct
3529049,125,0,25,65,40,25,25,Direct
3529035,250,40,50,230,180,50,50,Direct
3529342,250,55,20,180,160,20,20,Direct
3529410,175,5,35,160,125,35,35,Direct
3529478,75,0,20,180,160,20,20,Direct
3507968,225,30,35,155,120,35,35,Direct
3529517,150,0,20,130,110,20,20,Direct
3529567,175,10,150,300,150,150,150,Direct
3529721,175,15,35,120,85,35,35,Direct
3529960,200,30,50,275,225,50,50,Direct
3530103,50,0,35,150,115,35,35,Direct
3530253,50,0,20,140,120,20,20,Direct
3527002,175,10,35,165,130,35,35,Direct
3530857,100,0,20,120,100,20,20,Direct
3530882,250,40,35,225,190,35,35,Direct
3531032,75,0,20,150,130,20,20,Direct
3531257,175,10,35,190,155,35,35,Direct
3531575,100,0,35,160,125,35,35,Direct
3504899,275,85,35,185,150,35,35,Direct
3532261,450,165,50,250,200,50,50,Direct
3532461,150,0,70,250,180,70,70,Direct
3532704,200,25,35,125,90,35,35,Direct
3532886,150,5,50,220,170,50,50,Direct
3529185,100,0,35,145,110,35,35,Direct
3533036,150,0,50,210,160,50,50,Direct
3533504,250,65,50,305,255,50,50,Direct
3533997,150,0,20,120,100,20,20,Direct
3534022,175,10,35,155,120,35,35,Direct
3493271,275,75,35,150,115,35,35,Direct
3470314,200,35,35,140,105,35,35,Direct
3534247,200,20,34,144,110,34,34,Direct
3534333,175,5,25,90,65,25,25,Direct
3534626,75,0,20,180,160,20,20,Direct
3534801,250,105,50,220,170,50,50,Direct
3535426,175,5,35,195,160,35,35,Direct
3535576,50,0,35,175,140,35,35,Direct
3535601,225,45,75,315,240,75,75,Direct
3532125,200,30,35,185,150,35,35,Direct
3533529,75,0,20,70,50,20,20,Direct
3535712,375,150,50,325,275,50,50,Direct
3495825,175,15,35,190,155,35,35,Direct
3535776,175,15,35,195,160,35,35,Direct
3535894,175,10,40,325,285,40,40,Direct
3536051,250,50,35,150,115,35,35,Direct
3495599,75,0,50,250,200,50,50,Direct
3492761,400,170,35,245,210,35,35,Direct
3465519,175,0,10,20,10,10,10,Direct
3495769,125,0,35,170,135,35,35,Direct
3496101,200,30,50,275,225,50,50,Direct
3496135,275,55,50,240,190,50,50,Direct
3496378,300,100,50,320,270,50,50,Direct
3496403,175,10,20,145,125,20,20,Direct
3496603,300,90,50,290,240,50,50,Direct
3496646,150,0,20,160,140,20,20,Direct
3494140,200,55,35,150,115,35,35,Direct
3496914,100,0,50,230,180,50,50,Direct
3497046,175,5,35,250,215,35,35,Direct
3497271,250,40,35,180,145,35,35,Direct
3497280,50,0,60,150,90,60,60,Direct
3497446,175,0,45,195,150,45,45,Direct
3497505,100,0,35,140,105,35,35,Direct
3497616,225,45,35,155,120,35,35,Direct
3497671,250,40,35,135,100,35,35,Direct
3497773,275,70,50,250,200,50,50,Direct
3498050,175,10,50,205,155,50,50,Direct
3498084,325,85,20,180,160,20,20,Direct
3497607,175,0,35,155,120,35,35,Direct
3498373,325,105,35,170,135,35,35,Direct
3498407,175,5,20,170,150,20,20,Direct
3498450,200,25,40,210,170,40,40,Direct
3498884,200,25,50,275,225,50,50,Direct
3499752,175,15,60,115,55,60,60,Direct
3498675,200,20,50,325,275,50,50,Direct
3474343,100,0,37,152,115,37,37,Direct
3476190,225,45,50,275,225,50,50,Direct
3500888,175,0,50,275,225,50,50,Direct
3501117,300,90,35,190,155,35,35,Direct
3501058,200,20,50,220,170,50,50,Direct
3501360,225,55,35,125,90,35,35,Direct
3501390,450,170,50,235,185,50,50,Direct
3501356,125,0,35,125,90,35,35,Direct
3501049,225,45,35,190,155,35,35,Direct
3501751,175,10,35,180,145,35,35,Direct
3501794,200,20,20,170,150,20,20,Direct
3502028,25,0,35,250,215,35,35,Direct
3502092,175,15,35,105,70,35,35,Direct
3502083,150,0,35,145,110,35,35,Direct
3502428,25,0,35,170,135,35,35,Direct
3502419,100,0,35,185,150,35,35,Direct
3502496,175,10,50,200,150,50,50,Direct
3491664,225,45,35,150,115,35,35,Direct
3502662,775,405,140,630,490,140,140,Direct
3502585,200,30,35,120,85,35,35,Direct
3502785,225,45,50,285,235,50,50,Direct
3502994,225,50,20,180,160,20,20,Direct
3503053,75,0,50,325,275,50,50,Direct
3503228,225,45,20,95,75,20,20,Direct
3503487,75,0,50,210,160,50,50,Direct
3503589,200,30,35,135,100,35,35,Direct
3463822,100,0,20,80,60,20,20,Direct
3499611,150,0,5,10,5,5,5,Direct
3499592,100,0,35,260,225,35,35,Direct
3499809,325,80,20,150,130,20,20,Direct
3496631,200,25,35,275,240,35,35,Direct
3499992,325,110,50,375,325,50,50,Direct
3500107,100,0,35,145,110,35,35,Direct
3500141,450,165,40,245,205,40,40,Direct
3500324,225,35,35,160,125,35,35,Direct
3500392,100,0,35,160,125,35,35,Direct
3500409,200,25,35,120,85,35,35,Direct
3500528,100,0,35,125,90,35,35,Direct
3500694,325,100,55,400,345,55,55,Direct
3500728,125,0,35,265,230,35,35,Direct
3500792,175,10,35,155,120,35,35,Direct
3500809,300,60,50,245,195,50,50,Direct
3500911,150,0,20,150,130,20,20,Direct
3496231,250,65,35,105,70,35,35,Direct
3501043,150,5,35,175,140,35,35,Direct
3501145,50,0,35,190,155,35,35,Direct
3501294,150,0,35,190,155,35,35,Direct
3501796,75,0,35,135,100,35,35,Direct
3502400,200,25,50,230,180,50,50,Direct
3502515,525,220,50,275,225,50,50,Direct
3502566,300,95,50,200,150,50,50,Direct
3501396,175,0,20,160,140,20,20,Direct
3502664,175,10,35,140,105,35,35,Direct
3502617,200,10,20,80,60,20,20,Direct
3502749,225,40,50,265,215,50,50,Direct
3502766,175,15,35,140,105,35,35,Direct
3502817,300,90,35,160,125,35,35,Direct
3460518,25,0,40,210,170,40,40,Direct
3503336,400,215,50,340,290,50,50,Direct
3503553,250,45,60,175,115,60,60,Direct
3501979,150,0,20,170,150,20,20,Direct
3503834,175,20,35,155,120,35,35,Direct
3504004,200,15,20,85,65,20,20,Direct
3504421,225,15,35,155,120,35,35,Direct
3504404,125,0,50,275,225,50,50,Direct
3504723,125,0,25,75,50,25,25,Direct
3504872,175,15,60,165,105,60,60,Direct
3504889,200,25,36,176,140,36,36,Direct
3504923,50,0,50,375,325,50,50,Direct
3504906,50,0,35,155,120,35,35,Direct
3504838,25,0,20,190,170,20,20,Direct
3504987,125,0,35,160,125,35,35,Direct
3505425,175,5,35,180,145,35,35,Direct
3505204,400,140,50,245,195,50,50,Direct
3505272,75,0,50,275,225,50,50,Direct
3505591,75,0,35,150,115,35,35,Direct
3505740,225,45,35,160,125,35,35,Direct
3505957,450,145,50,275,225,50,50,Direct
3506327,200,10,20,50,30,20,20,Direct
3505191,175,10,35,135,100,35,35,Direct
3507629,75,0,20,95,75,20,20,Direct
3507731,75,0,20,180,160,20,20,Direct
3498448,200,25,20,190,170,20,20,Direct
3498843,175,15,50,205,155,50,50,Direct
3499043,225,30,35,190,155,35,35,Direct
3499618,100,0,20,135,115,20,20,Direct
3499409,225,45,75,300,225,75,75,Direct
3500056,50,0,50,220,170,50,50,Direct
3500222,150,5,35,145,110,35,35,Direct
3500320,225,30,35,100,65,35,35,Direct
3500447,100,0,35,190,155,35,35,Direct
3461016,200,25,50,230,180,50,50,Direct
3500847,125,0,35,170,135,35,35,Direct
3500924,250,70,60,150,90,60,60,Direct
3501047,250,45,20,85,65,20,20,Direct
3501290,250,55,35,155,120,35,35,Direct
3501460,200,35,35,190,155,35,35,Direct
3501515,100,0,25,60,35,25,25,Direct
3501685,175,10,35,225,190,35,35,Direct
3501860,275,75,50,250,200,50,50,Direct
3501894,50,0,20,80,60,20,20,Direct
3502017,225,30,35,150,115,35,35,Direct
3502094,100,0,35,170,135,35,35,Direct
3502251,425,115,20,180,160,20,20,Direct
3502226,275,70,20,180,160,20,20,Direct
3502328,125,0,20,85,65,20,20,Direct
3502685,375,120,50,375,325,50,50,Direct
3502753,175,10,35,245,210,35,35,Direct
3503089,175,5,35,185,150,35,35,Direct
3502987,475,170,100,290,190,100,100,Direct
3503128,75,0,35,165,130,35,35,Direct
3503332,200,15,50,230,180,50,50,Direct
3503655,250,40,50,260,210,50,50,Direct
3491998,200,30,35,190,155,35,35,Direct
3483944,200,20,40,275,235,40,40,Direct
3503864,175,15,35,160,125,35,35,Direct
3504157,175,15,35,195,160,35,35,Direct
3410676,250,40,50,275,225,50,50,Direct
3504289,150,0,35,155,120,35,35,Direct
3504425,125,0,35,135,100,35,35,Direct
3504732,125,0,35,140,105,35,35,Direct
3504834,275,55,35,135,100,35,35,Direct
3504868,250,45,20,140,120,20,20,Direct
3504961,275,75,35,190,155,35,35,Direct
3505059,125,0,35,160,125,35,35,Direct
3505025,250,40,37,167,130,37,37,Direct
3505136,100,0,35,135,100,35,35,Direct
3505195,200,20,50,325,275,50,50,Direct
3505200,175,5,50,275,225,50,50,Direct
3505259,225,30,20,130,110,20,20,Direct
3497880,75,0,35,180,145,35,35,Direct
3497373,150,0,35,170,135,35,35,Direct
3503857,100,0,35,225,190,35,35,Direct
3503964,125,0,20,140,120,20,20,Direct
3504023,325,90,20,120,100,20,20,Direct
3504359,75,0,60,195,135,60,60,Direct
3504534,125,0,20,80,60,20,20,Direct
3451781,50,0,25,85,60,25,25,Direct
3504691,400,150,100,270,170,100,100,Direct
3504934,175,5,35,210,175,35,35,Direct
3505070,100,0,45,155,110,45,45,Direct
3505227,175,5,50,220,170,50,50,Direct
3505236,175,10,50,200,150,50,50,Direct
3505368,125,0,35,140,105,35,35,Direct
3505904,250,45,50,235,185,50,50,Direct
3506095,100,0,18,78,60,18,18,Direct
3506699,175,5,35,190,155,35,35,Direct
3506763,100,0,35,180,145,35,35,Direct
3506933,175,10,25,85,60,25,25,Direct
3506972,25,0,35,115,80,35,35,Direct
3507006,75,0,20,140,120,20,20,Direct
3507031,150,0,35,170,135,35,35,Direct
3507167,125,0,35,155,120,35,35,Direct
3507206,475,170,55,410,355,55,55,Direct
3507367,100,0,35,150,115,35,35,Direct
3507601,125,0,35,155,120,35,35,Direct
3507665,225,35,50,240,190,50,50,Direct
3507674,175,10,20,150,130,20,20,Direct
3507699,250,65,50,370,320,50,50,Direct
3507767,200,30,50,265,215,50,50,Direct
3502819,225,30,50,265,215,50,50,Direct
3451347,75,0,35,260,225,35,35,Direct
3508546,300,75,50,220,170,50,50,Direct
3508601,75,0,20,170,150,20,20,Direct
3508712,250,50,35,190,155,35,35,Direct
3508805,325,85,50,260,210,50,50,Direct
3508980,200,25,50,200,150,50,50,Direct
3509239,225,35,35,100,65,35,35,Direct
3509278,175,10,35,155,120,35,35,Direct
3509312,150,0,50,225,175,50,50,Direct
3509371,175,10,50,275,225,50,50,Direct
3509439,150,0,50,250,200,50,50,Direct
3509512,250,50,50,250,200,50,50,Direct
3509507,75,0,20,50,30,20,20,Direct
3509546,225,30,35,140,105,35,35,Direct
3509673,225,50,35,175,140,35,35,Direct
3510005,200,30,20,160,140,20,20,Direct
3509980,175,10,35,165,130,35,35,Direct
3510341,100,0,25,75,50,25,25,Direct
3510409,100,0,35,285,250,35,35,Direct
3510584,200,30,25,85,60,25,25,Direct
3510682,300,90,50,220,170,50,50,Direct
3511009,175,5,50,230,180,50,50,Direct
3511120,50,0,20,160,140,20,20,Direct
3495404,225,45,35,225,190,35,35,Direct
3486512,75,0,35,125,90,35,35,Direct
3482117,200,15,35,125,90,35,35,Direct
3473462,100,0,20,95,75,20,20,Direct
3495621,350,105,35,195,160,35,35,Direct
3492413,125,0,35,150,115,35,35,Direct
3492446,200,30,35,135,100,35,35,Direct
3470250,125,0,35,130,95,35,35,Direct
3495854,200,20,35,255,220,35,35,Direct
3496225,150,0,20,140,120,20,20,Direct
3496289,225,35,50,210,160,50,50,Direct
3496275,175,10,35,190,155,35,35,Direct
3496489,50,0,35,165,130,35,35,Direct
3496675,125,0,25,95,70,25,25,Direct
3497411,75,0,35,150,115,35,35,Direct
3497258,125,0,35,150,115,35,35,Direct
3497811,100,0,35,225,190,35,35,Direct
3498130,100,0,35,150,115,35,35,Direct
3498361,200,20,35,155,120,35,35,Direct
3498680,100,0,35,165,130,35,35,Direct
3498815,75,0,35,180,145,35,35,Direct
3498829,250,45,35,125,90,35,35,Direct
3498897,225,45,20,130,110,20,20,Direct
3499480,200,20,50,325,275,50,50,Direct
3499948,200,35,20,80,60,20,20,Direct
3500084,400,185,50,245,195,50,50,Direct
3500101,225,45,35,280,245,35,35,Direct
3500169,100,0,35,155,120,35,35,Direct
3500284,275,70,20,160,140,20,20,Direct
3500283,125,0,20,170,150,20,20,Direct
3500369,150,0,35,190,155,35,35,Direct
3500419,225,35,50,250,200,50,50,Direct
3500416,150,0,20,180,160,20,20,Direct
3500402,275,85,20,135,115,20,20,Direct
3500534,100,0,25,60,35,25,25,Direct
3500569,125,0,35,190,155,35,35,Direct
3500938,300,100,35,260,225,35,35,Direct
3500952,300,145,35,250,215,35,35,Direct
3500969,175,10,35,180,145,35,35,Direct
3501002,250,45,50,205,155,50,50,Direct
3501155,175,10,25,75,50,25,25,Direct
3501287,300,90,35,195,160,35,35,Direct
3501338,75,0,35,155,120,35,35,Direct
3501355,125,0,20,170,150,20,20,Direct
3501402,250,65,50,345,295,50,50,Direct
3501538,200,30,35,120,85,35,35,Direct
3501555,125,0,50,275,225,50,50,Direct
3501756,225,45,35,150,115,35,35,Direct
3501755,100,0,50,275,225,50,50,Direct
3502088,150,0,35,150,115,35,35,Direct
3502288,175,10,20,45,25,20,20,Direct
3502555,150,0,35,270,235,35,35,Direct
3502773,150,0,20,135,115,20,20,Direct
3503610,225,45,50,275,225,50,50,Direct
3493599,100,0,20,95,75,20,20,Direct
3495254,0,0,35,250,215,35,35,Direct
3503878,100,0,35,170,135,35,35,Direct
3503892,175,10,35,155,120,35,35,Direct
3536094,75,0,35,125,90,35,35,Direct
3536119,200,25,35,250,215,35,35,Direct
3536255,225,30,50,270,220,50,50,Direct
3484772,125,0,50,230,180,50,50,Direct
3536523,200,30,35,150,115,35,35,Direct
3536580,125,0,35,190,155,35,35,Direct
3536912,250,60,20,190,170,20,20,Direct
3537098,250,65,35,185,150,35,35,Direct
3537941,200,10,50,275,225,50,50,Direct
3537966,200,20,20,75,55,20,20,Direct
3537991,50,0,35,230,195,35,35,Direct
3538077,250,35,35,190,155,35,35,Direct
3538141,175,5,50,240,190,50,50,Direct
3528674,300,75,20,190,170,20,20,Direct
3538570,300,80,35,155,120,35,35,Direct
3538584,225,45,20,140,120,20,20,Direct
3538634,75,0,20,75,55,20,20,Direct
3538659,200,30,35,135,100,35,35,Direct
3538745,425,120,35,170,135,35,35,Direct
3538988,50,0,35,170,135,35,35,Direct
3538770,325,95,50,375,325,50,50,Direct
3539145,100,0,35,150,115,35,35,Direct
3539127,300,75,50,250,200,50,50,Direct
3539595,25,0,20,120,100,20,20,Direct
3540213,425,145,35,240,205,35,35,Direct
3540388,75,0,35,200,165,35,35,Direct
3540599,225,30,50,220,170,50,50,Direct
3540681,275,65,35,155,120,35,35,Direct
3540935,175,5,35,215,180,35,35,Direct
3541017,325,105,50,220,170,50,50,Direct
3541217,275,85,35,225,190,35,35,Direct
3541260,75,0,50,205,155,50,50,Direct
3541324,250,65,50,205,155,50,50,Direct
3541378,175,20,35,160,125,35,35,Direct
3541685,175,0,20,65,45,20,20,Direct
3461047,100,0,35,185,150,35,35,Direct
3542060,100,0,20,180,160,20,20,Direct
3542071,150,0,50,220,170,50,50,Direct
3542135,350,115,35,230,195,35,35,Direct
3542353,200,30,150,300,150,150,150,Direct
3541060,500,195,110,410,300,110,110,Direct
3542421,250,45,20,180,160,20,20,Direct
3542514,225,35,50,220,170,50,50,Direct
3542714,175,10,35,150,115,35,35,Direct
3542889,275,70,35,210,175,35,35,Direct
3539706,125,0,35,155,120,35,35,Direct
3543475,200,20,35,155,120,35,35,Direct
3543689,200,15,35,125,90,35,35,Direct
3543757,175,10,25,50,25,25,25,Direct
3543893,225,55,35,115,80,35,35,Direct
3531214,50,0,20,165,145,20,20,Direct
3543957,175,10,35,125,90,35,35,Direct
3544000,225,45,20,160,140,20,20,Direct
3544075,100,0,35,265,230,35,35,Direct
3551671,175,10,35,110,75,35,35,Direct
3552137,100,0,35,155,120,35,35,Direct
3552580,375,135,50,360,310,50,50,Direct
3553250,225,30,35,165,130,35,35,Direct
3553352,250,50,60,195,135,60,60,Direct
3553509,200,35,50,210,160,50,50,Direct
3553616,250,45,50,230,180,50,50,Direct
3553650,50,0,50,230,180,50,50,Direct
3553745,225,25,50,225,175,50,50,Direct
3553950,150,0,50,230,180,50,50,Direct
3553943,200,25,35,190,155,35,35,Direct
3555015,350,85,50,225,175,50,50,Direct
3556115,175,10,20,140,120,20,20,Direct
3556215,125,0,35,190,155,35,35,Direct
3556424,100,0,35,155,120,35,35,Direct
3557060,250,105,50,275,225,50,50,Direct
3557187,50,0,35,120,85,35,35,Direct
3557430,50,0,35,145,110,35,35,Direct
3557996,175,5,35,170,135,35,35,Direct
3558287,225,45,50,325,275,50,50,Direct
3558466,200,25,35,150,115,35,35,Direct
3558859,100,0,20,165,145,20,20,Direct
3559432,175,15,33,148,115,33,33,Direct
3559459,250,65,35,160,125,35,35,Direct
3559661,200,35,35,190,155,35,35,Direct
3559961,250,50,35,195,160,35,35,Direct
3560059,75,0,35,180,145,35,35,Direct
3560159,100,0,35,170,135,35,35,Direct
3560504,225,45,75,325,250,75,75,Direct
3560804,100,0,35,245,210,35,35,Direct
3560997,75,0,60,190,130,60,60,Direct
3561204,225,40,50,200,150,50,50,Direct
3561304,175,5,50,200,150,50,50,Direct
3561404,175,5,50,200,150,50,50,Direct
3561697,250,45,35,175,140,35,35,Direct
3562131,50,0,20,160,140,20,20,Direct
3562167,175,10,35,290,255,35,35,Direct
3562569,175,15,35,150,115,35,35,Direct
3562976,175,10,50,320,270,50,50,Direct
3563103,100,0,35,155,120,35,35,Direct
3563669,175,15,50,210,160,50,50,Direct
3564239,175,20,35,185,150,35,35,Direct
3565377,100,0,40,240,200,40,40,Direct
3565518,250,45,60,165,105,60,60,Direct
3565575,250,45,20,160,140,20,20,Direct
3566084,25,0,35,135,100,35,35,Direct
3566577,100,0,20,75,55,20,20,Direct
3567147,225,40,75,315,240,75,75,Direct
3567213,175,5,35,185,150,35,35,Direct
3567313,150,0,20,75,55,20,20,Direct
3567354,275,60,35,150,115,35,35,Direct
3567656,100,0,35,125,90,35,35,Direct
3567690,100,0,50,230,180,50,50,Direct
3567813,200,15,35,160,125,35,35,Direct
3486393,375,160,50,310,260,50,50,Direct
3486591,200,30,60,155,95,60,60,Direct
3486770,225,0,20,170,150,20,20,Direct
3486870,25,0,20,120,100,20,20,Direct
3487029,150,0,35,160,125,35,35,Direct
3487036,100,0,35,175,140,35,35,Direct
3487227,175,15,60,195,135,60,60,Direct
3487234,200,30,50,385,335,50,50,Direct
3487370,175,10,50,250,200,50,50,Direct
3487429,100,0,35,245,210,35,35,Direct
3487570,275,120,50,230,180,50,50,Direct
3487936,100,0,35,100,65,35,35,Direct
3488270,100,0,35,150,115,35,35,Direct
3488306,175,5,20,180,160,20,20,Direct
3488429,50,0,35,225,190,35,35,Direct
3488499,75,0,60,110,50,60,60,Direct
3488706,200,20,20,160,140,20,20,Direct
3489301,200,10,35,245,210,35,35,Direct
3489401,200,25,25,60,35,25,25,Direct
3489442,200,30,35,160,125,35,35,Direct
3489535,275,60,50,325,275,50,50,Direct
3489742,250,70,50,225,175,50,50,Direct
3489935,150,0,25,70,45,25,25,Direct
3489944,250,30,40,230,190,40,40,Direct
3490201,175,10,35,250,215,35,35,Direct
3490371,125,0,60,140,80,60,60,Direct
3490535,300,100,75,375,300,75,75,Direct
3490871,150,5,50,250,200,50,50,Direct
3490937,75,0,50,210,160,50,50,Direct
3491073,125,0,20,90,70,20,20,Direct
3491178,75,0,50,200,150,50,50,Direct
3491237,100,0,50,275,225,50,50,Direct
3491373,175,5,20,175,155,20,20,Direct
3491371,250,50,20,80,60,20,20,Direct
3480375,125,0,18,23,5,18,18,Direct
3491714,175,10,50,265,215,50,50,Direct
3491780,200,25,50,235,185,50,50,Direct
3491816,150,0,35,150,115,35,35,Direct
3491807,200,25,60,115,55,60,60,Direct
3491850,50,0,35,115,80,35,35,Direct
3492073,50,0,35,170,135,35,35,Direct
3492014,25,0,20,130,110,20,20,Direct
3492050,50,0,50,200,150,50,50,Direct
3492116,400,175,50,270,220,50,50,Direct
3492173,225,30,20,80,60,20,20,Direct
3492350,425,120,100,260,160,100,100,Direct
3492452,200,35,20,165,145,20,20,Direct
3492552,175,10,35,145,110,35,35,Direct
3492643,150,0,35,250,215,35,35,Direct
3492752,250,45,20,80,60,20,20,Direct
3492845,250,55,50,200,150,50,50,Direct
3493286,100,0,50,205,155,50,50,Direct
3493445,125,0,20,65,45,20,20,Direct
3493486,50,0,25,75,50,25,25,Direct
3493686,175,10,50,250,200,50,50,Direct
3472053,175,10,35,120,85,35,35,Direct
3513812,325,110,50,260,210,50,50,Direct
3513895,100,0,20,50,30,20,20,Direct
3514012,125,0,50,275,225,50,50,Direct
3514346,300,90,50,250,200,50,50,Direct
3514448,75,0,20,165,145,20,20,Direct
3514867,275,60,20,95,75,20,20,Direct
3514948,225,35,35,135,100,35,35,Direct
3515148,175,15,20,50,30,20,20,Direct
3515367,325,45,100,275,175,100,100,Direct
3514082,275,60,50,260,210,50,50,Direct
3510153,125,0,75,315,240,75,75,Direct
3508666,100,0,20,180,160,20,20,Direct
3508396,225,35,20,170,150,20,20,Direct
3509553,50,0,35,120,85,35,35,Direct
3515467,100,0,35,115,80,35,35,Direct
3515633,100,0,35,160,125,35,35,Direct
3515733,300,100,50,375,325,50,50,Direct
3515769,175,15,35,160,125,35,35,Direct
3515954,75,0,20,120,100,20,20,Direct
3516020,175,20,35,250,215,35,35,Direct
3516118,75,0,35,155,120,35,35,Direct
3516120,100,0,40,285,245,40,40,Direct
3516218,200,20,50,250,200,50,50,Direct
3516254,75,0,50,225,175,50,50,Direct
3516369,175,5,35,250,215,35,35,Direct
3516469,200,20,35,175,140,35,35,Direct
3516705,150,0,20,160,140,20,20,Direct
3487023,25,0,25,75,50,25,25,Direct
3516754,250,45,35,175,140,35,35,Direct
3516990,250,55,35,185,150,35,35,Direct
3517105,225,35,35,160,125,35,35,Direct
3517154,200,35,35,145,110,35,35,Direct
3517139,50,0,35,140,105,35,35,Direct
3517241,150,0,35,190,155,35,35,Direct
3516820,475,165,75,350,275,75,75,Direct
3517354,1150,605,450,1365,915,450,450,Direct
3517956,100,0,40,245,205,40,40,Direct
3518092,200,35,35,105,70,35,35,Direct
3518492,850,440,155,700,545,155,155,Direct
3518641,100,0,35,165,130,35,35,Direct
3519011,150,0,50,225,175,50,50,Direct
3519177,325,85,35,250,215,35,35,Direct
3519428,200,15,50,285,235,50,50,Direct
3519713,100,0,35,265,230,35,35,Direct
3519928,175,15,35,185,150,35,35,Direct
3417833,50,0,35,110,75,35,35,Direct
3510604,125,0,35,180,145,35,35,Direct
3517692,75,0,35,255,220,35,35,Direct
3520483,225,45,50,240,190,50,50,Direct
3520600,100,0,35,180,145,35,35,Direct
3500829,75,0,50,220,170,50,50,Direct
3520649,125,0,25,80,55,25,25,Direct
3520647,25,0,35,245,210,35,35,Direct
3520683,100,0,20,140,120,20,20,Direct
3501180,125,0,35,190,155,35,35,Direct
3521100,175,5,35,270,235,35,35,Direct
3508161,125,0,25,85,60,25,25,Direct
3508679,200,30,50,200,150,50,50,Direct
3508743,225,35,50,325,275,50,50,Direct
3508947,25,0,35,190,155,35,35,Direct
3508986,125,0,35,160,125,35,35,Direct
3509229,175,5,35,250,215,35,35,Direct
3510072,450,145,50,270,220,50,50,Direct
3510097,125,0,50,260,210,50,50,Direct
3510633,100,0,35,195,160,35,35,Direct
3510683,125,0,35,125,90,35,35,Direct
3510765,400,190,35,260,225,35,35,Direct
3499869,25,0,35,125,90,35,35,Direct
3487819,175,10,35,180,145,35,35,Direct
3511437,100,0,35,125,90,35,35,Direct
3511637,100,0,35,150,115,35,35,Direct
3511730,150,0,35,290,255,35,35,Direct
3511794,200,30,60,150,90,60,60,Direct
3511930,175,0,60,150,90,60,60,Direct
3512130,100,0,20,105,85,20,20,Direct
3512305,175,10,60,100,40,60,60,Direct
3512330,175,5,35,150,115,35,35,Direct
3512423,150,0,50,210,160,50,50,Direct
3511969,325,100,20,170,150,20,20,Direct
3512666,200,15,20,170,150,20,20,Direct
3512730,100,0,50,275,225,50,50,Direct
3512816,125,0,25,95,70,25,25,Direct
3513359,175,20,25,80,55,25,25,Direct
3512637,200,20,20,160,140,20,20,Direct
3496568,125,0,35,225,190,35,35,Direct
3513802,175,10,50,230,180,50,50,Direct
3514177,175,20,35,260,225,35,35,Direct
3514284,250,45,50,275,225,50,50,Direct
3514509,100,0,35,155,120,35,35,Direct
3514552,125,0,50,230,180,50,50,Direct
3514620,1025,650,400,1165,765,400,400,Direct
3514977,100,0,20,190,170,20,20,Direct
3515181,150,5,35,240,205,35,35,Direct
3515431,200,20,50,270,220,50,50,Direct
3491624,125,0,35,110,75,35,35,Direct
3515488,50,0,35,260,225,35,35,Direct
3515649,250,75,35,145,110,35,35,Direct
3515756,225,25,20,150,130,20,20,Direct
3515781,225,35,35,185,150,35,35,Direct
3515849,75,0,50,275,225,50,50,Direct
3516156,300,90,35,150,115,35,35,Direct
3516088,200,15,50,210,160,50,50,Direct
3516117,225,25,50,260,210,50,50,Direct
3516367,375,110,35,155,120,35,35,Direct
3516767,50,0,35,225,190,35,35,Direct
3524441,150,0,50,275,225,50,50,Direct
3524475,100,0,50,220,170,50,50,Direct
3506461,150,0,35,150,115,35,35,Direct
3524577,375,140,75,310,235,75,75,Direct
3524709,175,0,35,135,100,35,35,Direct
3524726,150,0,35,190,155,35,35,Direct
3524811,200,30,60,105,45,60,60,Direct
3524943,200,10,60,150,90,60,60,Direct
3525309,125,0,35,100,65,35,35,Direct
3525679,225,35,20,180,160,20,20,Direct
3525764,250,55,35,180,145,35,35,Direct
3525794,275,75,40,235,195,40,40,Direct
3525845,200,20,35,100,65,35,35,Direct
3525947,175,10,35,155,120,35,35,Direct
3526079,125,0,35,180,145,35,35,Direct
3526496,100,0,35,165,130,35,35,Direct
3526513,250,50,35,175,140,35,35,Direct
3526564,100,0,35,240,205,35,35,Direct
3526649,175,15,50,200,150,50,50,Direct
3526730,100,0,20,160,140,20,20,Direct
3526934,250,50,50,200,150,50,50,Direct
3527249,350,100,20,170,150,20,20,Direct
3527483,175,5,50,205,155,50,50,Direct
3527853,325,110,50,270,220,50,50,Direct
3525462,175,15,20,140,120,20,20,Direct
3528304,200,30,50,255,205,50,50,Direct
3528602,175,15,35,185,150,35,35,Direct
3528819,225,45,20,180,160,20,20,Direct
3528870,100,0,50,200,150,50,50,Direct
3529040,475,165,20,190,170,20,20,Direct
3529121,375,120,20,145,125,20,20,Direct
3529206,300,85,50,275,225,50,50,Direct
3529223,275,55,35,155,120,35,35,Direct
3529355,50,0,45,195,150,45,45,Direct
3529338,325,85,50,310,260,50,50,Direct
3529959,350,105,75,300,225,75,75,Direct
3530057,200,40,35,160,125,35,35,Direct
3530074,150,5,35,180,145,35,35,Direct
3530125,125,0,20,140,120,20,20,Direct
3530206,125,0,35,195,160,35,35,Direct
3530274,50,0,35,165,130,35,35,Direct
3529189,150,0,50,220,170,50,50,Direct
3530559,325,110,110,420,310,110,110,Direct
3529989,250,50,35,120,85,35,35,Direct
3530691,100,0,25,85,60,25,25,Direct
3530661,175,5,35,185,150,35,35,Direct
3530827,350,120,50,265,215,50,50,Direct
3531027,200,30,50,255,205,50,50,Direct
3531329,150,0,20,110,90,20,20,Direct
3531627,250,65,55,420,365,55,55,Direct
3531661,125,0,35,140,105,35,35,Direct
3531861,225,45,36,101,65,36,36,Direct
3503977,175,10,50,275,225,50,50,Direct
3504028,100,0,20,50,30,20,20,Direct
3504027,425,195,50,375,325,50,50,Direct
3504163,100,0,35,145,110,35,35,Direct
3504177,250,70,50,275,225,50,50,Direct
3504428,50,0,35,235,200,35,35,Direct
3504513,225,45,50,205,155,50,50,Direct
3505249,175,15,50,340,290,50,50,Direct
3505381,150,0,35,240,205,35,35,Direct
3505517,200,35,35,125,90,35,35,Direct
3505764,400,120,70,245,175,70,70,Direct
3505699,225,40,20,80,60,20,20,Direct
3505849,300,85,50,230,180,50,50,Direct
3505882,175,5,50,205,155,50,50,Direct
3506049,125,0,35,170,135,35,35,Direct
3506117,200,30,75,385,310,75,75,Direct
3506517,175,5,50,210,160,50,50,Direct
3506768,175,20,35,285,250,35,35,Direct
3506886,175,10,35,240,205,35,35,Direct
3507036,100,0,50,200,150,50,50,Direct
3507086,100,0,35,225,190,35,35,Direct
3507154,100,0,35,155,120,35,35,Direct
3507185,200,15,50,300,250,50,50,Direct
3504581,125,0,35,155,120,35,35,Direct
3497625,175,0,35,265,230,35,35,Direct
3476688,150,0,35,255,220,35,35,Direct
3468749,25,0,20,120,100,20,20,Direct
3507636,175,15,35,230,195,35,35,Direct
3507754,1100,620,400,1165,765,400,400,Direct
3507839,250,50,35,260,225,35,35,Direct
3507853,325,105,50,270,220,50,50,Direct
3507972,100,0,75,300,225,75,75,Direct
3508121,275,60,20,190,170,20,20,Direct
3508839,125,0,20,50,30,20,20,Direct
3509057,125,0,50,240,190,50,50,Direct
3509175,200,25,59,114,55,59,59,Direct
3509325,275,60,35,165,130,35,35,Direct
3509494,225,60,35,190,155,35,35,Direct
3509644,50,0,50,205,155,50,50,Direct
3509775,200,30,50,220,170,50,50,Direct
3509826,150,5,50,225,175,50,50,Direct
3509993,150,0,40,220,180,40,40,Direct
3510243,150,0,35,150,115,35,35,Direct
3510797,175,10,20,160,140,20,20,Direct
3510865,250,65,35,160,125,35,35,Direct
3500701,150,0,35,150,115,35,35,Direct
3511166,325,95,35,140,105,35,35,Direct
3511247,50,0,60,155,95,60,60,Direct
3511515,150,0,20,140,120,20,20,Direct
3511447,175,0,25,50,25,25,25,Direct
3511733,175,10,35,155,120,35,35,Direct
3511797,275,65,35,170,135,35,35,Direct
3511834,150,0,35,165,130,35,35,Direct
3511848,125,0,35,160,125,35,35,Direct
3511933,225,35,75,300,225,75,75,Direct
3512116,325,85,35,150,115,35,35,Direct
3512166,100,0,20,150,130,20,20,Direct
3512184,325,95,35,195,160,35,35,Direct
3512269,150,5,25,85,60,25,25,Direct
3512702,250,55,50,250,200,50,50,Direct
3511175,275,45,50,240,190,50,50,Direct
3511277,175,5,50,260,210,50,50,Direct
3511384,200,35,35,190,155,35,35,Direct
3511813,175,10,20,145,125,20,20,Direct
3502462,50,0,35,170,135,35,35,Direct
3512056,350,135,50,200,150,50,50,Direct
3512281,75,0,35,160,125,35,35,Direct
3512311,350,130,35,290,255,35,35,Direct
3512622,175,5,50,325,275,50,50,Direct
3513524,200,35,50,225,175,50,50,Direct
3513724,100,0,20,175,155,20,20,Direct
3513792,250,45,35,165,130,35,35,Direct
3514060,175,5,24,69,45,24,24,Direct
3514051,175,10,35,160,125,35,35,Direct
3514085,100,0,50,200,150,50,50,Direct
3514251,175,5,35,145,110,35,35,Direct
3514319,150,5,35,210,175,35,35,Direct
3514353,175,10,60,195,135,60,60,Direct
3514587,400,160,50,275,225,50,50,Direct
3508269,75,0,35,160,125,35,35,Direct
3514660,200,20,50,270,220,50,50,Direct
3514728,175,10,20,75,55,20,20,Direct
3515064,100,0,35,190,155,35,35,Direct
3506772,100,0,35,130,95,35,35,Direct
3508971,225,30,50,270,220,50,50,Direct
3503398,225,35,34,154,120,34,34,Direct
3515621,175,5,50,270,220,50,50,Direct
3516132,175,10,35,155,120,35,35,Direct
3516166,25,0,35,100,65,35,35,Direct
3516366,200,30,35,100,65,35,35,Direct
3516634,150,0,20,180,160,20,20,Direct
3516693,75,0,35,190,155,35,35,Direct
3516791,250,50,20,160,140,20,20,Direct
3516859,175,10,40,375,335,40,40,Direct
3517166,75,0,35,170,135,35,35,Direct
3479934,250,55,60,140,80,60,60,Direct
3516936,150,0,25,85,60,25,25,Direct
3517161,75,0,20,110,90,20,20,Direct
3517327,250,65,20,155,135,20,20,Direct
3517370,125,0,35,190,155,35,35,Direct
3517434,250,45,50,230,180,50,50,Direct
3517459,150,0,35,150,115,35,35,Direct
3517659,50,0,50,325,275,50,50,Direct
3517893,100,0,35,180,145,35,35,Direct
3518127,125,0,35,175,140,35,35,Direct
3518161,250,65,75,395,320,75,75,Direct
3518263,200,10,50,230,180,50,50,Direct
3518799,225,45,50,260,210,50,50,Direct
3518804,125,0,20,190,170,20,20,Direct
3519033,100,0,0,5,5,0,0,Direct
3519199,100,0,20,95,75,20,20,Direct
3519501,175,20,50,210,160,50,50,Direct
3516825,150,0,50,240,190,50,50,Direct
3520033,75,0,50,250,200,50,50,Direct
3520101,150,0,35,170,135,35,35,Direct
3495159,125,0,35,125,90,35,35,Direct
3495316,150,0,50,200,150,50,50,Direct
3495409,75,0,18,98,80,18,18,Direct
3479483,175,15,35,150,115,35,35,Direct
3494966,50,0,35,145,110,35,35,Direct
3495816,375,185,75,390,315,75,75,Direct
3496145,150,0,5,10,5,5,5,Direct
3496159,100,0,34,124,90,34,34,Direct
3496302,225,15,35,150,115,35,35,Direct
3496652,275,80,50,245,195,50,50,Direct
3496638,275,55,50,265,215,50,50,Direct
3496788,300,85,35,190,155,35,35,Direct
3496881,375,165,50,275,225,50,50,Direct
3496931,275,40,50,230,180,50,50,Direct
3497538,200,25,35,135,100,35,35,Direct
3497631,225,45,60,150,90,60,60,Direct
3497624,75,0,50,235,185,50,50,Direct
3497788,300,85,35,225,190,35,35,Direct
3497688,150,0,25,75,50,25,25,Direct
3497738,575,280,80,405,325,80,80,Direct
3497974,100,0,50,225,175,50,50,Direct
3498024,125,0,20,95,75,20,20,Direct
3498567,200,5,50,280,230,50,50,Direct
3495452,125,0,50,280,230,50,50,Direct
3498774,150,0,50,210,160,50,50,Direct
3498853,75,0,35,180,145,35,35,Direct
3474717,350,185,35,265,230,35,35,Direct
3499103,375,140,35,225,190,35,35,Direct
3499167,350,100,35,150,115,35,35,Direct
3498674,175,10,35,135,100,35,35,Direct
3499710,250,60,75,310,235,75,75,Direct
3499996,250,50,75,365,290,75,75,Direct
3500089,175,15,35,185,150,35,35,Direct
3500153,125,0,20,75,55,20,20,Direct
3500253,100,0,50,220,170,50,50,Direct
3500346,225,45,35,160,125,35,35,Direct
3500489,250,60,50,240,190,50,50,Direct
3500496,450,170,35,260,225,35,35,Direct
3500696,175,15,35,155,120,35,35,Direct
3501139,200,40,50,250,200,50,50,Direct
3501268,100,0,35,225,190,35,35,Direct
3501289,250,65,50,205,155,50,50,Direct
3501475,175,0,50,215,165,50,50,Direct
3462435,225,30,35,240,205,35,35,Direct
3501761,125,0,35,145,110,35,35,Direct
3501825,100,0,35,155,120,35,35,Direct
3501868,75,0,35,160,125,35,35,Direct
3501911,50,0,20,25,5,20,20,Direct
3502068,200,25,35,190,155,35,35,Direct
3502218,75,0,20,160,140,20,20,Direct
3502511,150,0,20,55,35,20,20,Direct
3502604,200,25,35,155,120,35,35,Direct
3493794,100,0,25,60,35,25,25,Direct
3544143,125,0,20,80,60,20,20,Direct
3544493,325,100,35,235,200,35,35,Direct
3535119,25,0,50,220,170,50,50,Direct
3545336,100,0,35,275,240,35,35,Direct
3545361,300,105,55,400,345,55,55,Direct
3545522,175,10,35,150,115,35,35,Direct
3482239,50,0,35,265,230,35,35,Direct
3545736,175,10,25,85,60,25,25,Direct
3545879,225,20,20,170,150,20,20,Direct
3545940,150,5,20,65,45,20,20,Direct
3545965,225,35,50,270,220,50,50,Direct
3546590,225,45,60,170,110,60,60,Direct
3546940,150,5,35,155,120,35,35,Direct
3547283,300,95,50,200,150,50,50,Direct
3547458,175,10,35,185,150,35,35,Direct
3547526,175,10,35,190,155,35,35,Direct
3547608,275,75,35,210,175,35,35,Direct
3547633,250,45,50,210,160,50,50,Direct
3547812,225,35,35,140,105,35,35,Direct
3547951,300,100,50,265,215,50,50,Direct
3548062,50,0,35,180,145,35,35,Direct
3548087,100,0,50,250,200,50,50,Direct
3548144,150,0,20,175,155,20,20,Direct
3548280,275,55,20,190,170,20,20,Direct
3547433,250,45,35,145,110,35,35,Direct
3546901,125,0,35,140,105,35,35,Direct
3548930,75,0,35,150,115,35,35,Direct
3549480,225,45,20,140,120,20,20,Direct
3550084,125,0,20,175,155,20,20,Direct
3550266,225,40,35,275,240,35,35,Direct
3550377,250,50,75,320,245,75,75,Direct
3550402,200,25,50,230,180,50,50,Direct
3550559,175,5,35,210,175,35,35,Direct
3550641,175,10,35,150,115,35,35,Direct
3545161,250,65,35,150,115,35,35,Direct
3551020,75,0,35,185,150,35,35,Direct
3551202,425,120,50,220,170,50,50,Direct
3551338,100,0,35,100,65,35,35,Direct
3551352,100,0,20,80,60,20,20,Direct
3551513,125,0,50,230,180,50,50,Direct
3551602,275,75,50,235,185,50,50,Direct
3551688,125,0,35,270,235,35,35,Direct
3551913,225,45,50,235,185,50,50,Direct
3552356,75,0,35,150,115,35,35,Direct
3541335,350,125,75,315,240,75,75,Direct
3552981,100,0,20,160,140,20,20,Direct
3553224,100,0,20,60,40,20,20,Direct
3553424,350,125,50,225,175,50,50,Direct
3553492,225,40,75,385,310,75,75,Direct
3553499,275,70,35,135,100,35,35,Direct
3553628,150,0,20,75,55,20,20,Direct
3553835,50,0,50,205,155,50,50,Direct
3554035,200,30,50,255,205,50,50,Direct
3554160,225,30,50,235,185,50,50,Direct
3554228,200,20,35,100,65,35,35,Direct
3554296,225,45,35,190,155,35,35,Direct
3554478,300,85,50,260,210,50,50,Direct
3554589,100,0,35,155,120,35,35,Direct
3554678,200,35,60,195,135,60,60,Direct
3555614,200,15,35,180,145,35,35,Direct
3513069,225,45,40,230,190,40,40,Direct
3513370,125,0,20,140,120,20,20,Direct
3511048,150,0,25,85,60,25,25,Direct
3504546,175,15,35,140,105,35,35,Direct
3513855,400,125,50,260,210,50,50,Direct
3513920,125,0,35,125,90,35,35,Direct
3514056,350,135,110,415,305,110,110,Direct
3514124,275,85,35,190,155,35,35,Direct
3514174,225,30,60,115,55,60,60,Direct
3514388,100,0,35,115,80,35,35,Direct
3514642,125,0,35,105,70,35,35,Direct
3514673,100,0,20,90,70,20,20,Direct
3514791,175,5,35,150,115,35,35,Direct
3515009,25,0,35,175,140,35,35,Direct
3515056,250,45,35,180,145,35,35,Direct
3515191,400,135,35,190,155,35,35,Direct
3515209,50,0,20,75,55,20,20,Direct
3485694,250,40,35,145,110,35,35,Direct
3515578,225,35,35,215,180,35,35,Direct
3515859,200,15,35,225,190,35,35,Direct
3516077,325,85,35,250,215,35,35,Direct
3516127,400,140,35,190,155,35,35,Direct
3516196,250,65,50,395,345,50,50,Direct
3516413,175,15,35,135,100,35,35,Direct
3516460,250,65,50,225,175,50,50,Direct
3506500,125,0,35,140,105,35,35,Direct
3480963,175,10,20,140,120,20,20,Direct
3516728,275,75,50,250,200,50,50,Direct
3517064,150,0,35,165,130,35,35,Direct
3517131,175,10,35,150,115,35,35,Direct
3517196,275,60,35,175,140,35,35,Direct
3517199,200,20,35,135,100,35,35,Direct
3517331,225,30,20,140,120,20,20,Direct
3517396,75,0,35,100,65,35,35,Direct
3517446,375,135,50,260,210,50,50,Direct
3517799,75,0,35,290,255,35,35,Direct
3517817,300,75,50,325,275,50,50,Direct
3518318,225,25,20,65,45,20,20,Direct
3518335,150,0,35,140,105,35,35,Direct
3419514,100,0,35,140,105,35,35,Direct
3518685,75,0,35,135,100,35,35,Direct
3518800,175,15,50,200,150,50,50,Direct
3518935,50,0,35,125,90,35,35,Direct
3518953,225,45,75,300,225,75,75,Direct
3519003,75,0,20,140,120,20,20,Direct
3519067,375,140,75,315,240,75,75,Direct
3519071,225,40,35,155,120,35,35,Direct
3519203,250,50,35,250,215,35,35,Direct
3519268,175,10,25,95,70,25,25,Direct
3519221,250,55,35,125,90,35,35,Direct
3519353,100,0,35,180,145,35,35,Direct
3519536,125,0,35,185,150,35,35,Direct
3505049,175,10,35,160,125,35,35,Direct
3496072,275,60,20,140,120,20,20,Direct
3520089,150,0,50,250,200,50,50,Direct
3520122,175,15,35,150,115,35,35,Direct
3437979,450,140,50,260,210,50,50,Direct
3520233,200,40,35,150,115,35,35,Direct
3520276,50,0,35,190,155,35,35,Direct
3520569,175,10,35,185,150,35,35,Direct
3520178,225,30,40,375,335,40,40,Direct
3520637,225,15,35,175,140,35,35,Direct
3520612,300,90,35,185,150,35,35,Direct
3520676,50,0,35,135,100,35,35,Direct
3520710,175,15,20,180,160,20,20,Direct
3520803,225,60,50,275,225,50,50,Direct
3520871,650,315,55,400,345,55,55,Direct
3520910,375,120,50,225,175,50,50,Direct
3520935,75,0,35,140,105,35,35,Direct
3521178,325,85,20,185,165,20,20,Direct
3521203,200,15,35,170,135,35,35,Direct
3521237,125,0,35,150,115,35,35,Direct
3521280,250,50,20,175,155,20,20,Direct
3500322,125,0,10,15,5,10,10,Direct
3521437,350,110,20,160,140,20,20,Direct
3521773,175,10,35,115,80,35,35,Direct
3521914,250,40,50,225,175,50,50,Direct
3521905,150,0,40,230,190,40,40,Direct
3521982,200,35,35,265,230,35,35,Direct
3522182,175,20,35,185,150,35,35,Direct
3522348,100,0,35,170,135,35,35,Direct
3522373,475,170,75,360,285,75,75,Direct
3522777,125,0,20,70,50,20,20,Direct
3522909,100,0,35,140,105,35,35,Direct
3523075,250,45,20,170,150,20,20,Direct
3523177,250,65,50,285,235,50,50,Direct
3523343,175,0,50,200,150,50,50,Direct
3457738,200,30,35,190,155,35,35,Direct
3523484,250,55,20,85,65,20,20,Direct
3523679,200,35,50,260,210,50,50,Direct
3523752,500,195,50,265,215,50,50,Direct
3520905,500,215,110,400,290,110,110,Direct
3523879,250,50,35,155,120,35,35,Direct
3506372,250,50,35,285,250,35,35,Direct
3515757,400,165,35,230,195,35,35,Direct
3524245,300,100,35,150,115,35,35,Direct
3524322,100,0,50,240,190,50,50,Direct
3524479,125,0,35,165,130,35,35,Direct
3524654,175,10,20,190,170,20,20,Direct
3524756,175,5,50,235,185,50,50,Direct
3524824,200,35,35,150,115,35,35,Direct
3525122,75,0,50,250,200,50,50,Direct
3525347,325,130,40,275,235,40,40,Direct
3525356,200,5,35,190,155,35,35,Direct
3525658,200,30,35,150,115,35,35,Direct
3525760,300,55,50,205,155,50,50,Direct
3526394,175,5,40,230,190,40,40,Direct
3526662,175,5,25,65,40,25,25,Direct
3526585,125,0,35,160,125,35,35,Direct
3526721,250,45,25,90,65,25,25,Direct
3505627,100,0,20,130,110,20,20,Direct
3526760,375,135,20,175,155,20,20,Direct
3526751,75,0,50,220,170,50,50,Direct
3519467,150,0,35,125,90,35,35,Direct
3526926,125,0,35,150,115,35,35,Direct
3527087,250,60,33,128,95,33,33,Direct
3527394,250,45,20,80,60,20,20,Direct
3527423,125,0,35,160,125,35,35,Direct
3502747,225,45,20,140,120,20,20,Direct
3503011,175,10,35,135,100,35,35,Direct
3503211,50,0,50,230,180,50,50,Direct
3503161,75,0,20,95,75,20,20,Direct
3503190,100,0,20,60,40,20,20,Direct
3503304,475,190,50,290,240,50,50,Direct
3503590,175,5,35,180,145,35,35,Direct
3503933,100,0,20,170,150,20,20,Direct
3504147,200,35,35,150,115,35,35,Direct
3504233,75,0,50,275,225,50,50,Direct
3504433,275,85,49,214,165,49,49,Direct
3504576,175,5,35,190,155,35,35,Direct
3504590,100,0,35,230,195,35,35,Direct
3504826,175,0,50,210,160,50,50,Direct
3504876,50,0,50,250,200,50,50,Direct
3504983,350,100,50,275,225,50,50,Direct
3505033,100,0,35,145,110,35,35,Direct
3505226,250,60,50,220,170,50,50,Direct
3505262,125,0,35,180,145,35,35,Direct
3505276,325,120,35,245,210,35,35,Direct
3505362,75,0,20,90,70,20,20,Direct
3505426,200,20,50,335,285,50,50,Direct
3505612,200,30,50,200,150,50,50,Direct
3505855,125,0,50,230,180,50,50,Direct
3506098,450,170,50,310,260,50,50,Direct
3506112,225,35,25,85,60,25,25,Direct
3506055,200,30,35,245,210,35,35,Direct
3506155,125,0,50,225,175,50,50,Direct
3506262,50,0,33,143,110,33,33,Direct
3506348,75,0,10,15,5,10,10,Direct
3506548,175,10,50,220,170,50,50,Direct
3506612,325,105,35,240,205,35,35,Direct
3506798,325,115,50,350,300,50,50,Direct
3506841,150,5,20,75,55,20,20,Direct
3506991,100,0,50,235,185,50,50,Direct
3507005,200,35,35,170,135,35,35,Direct
3507148,250,50,50,375,325,50,50,Direct
3507284,400,165,50,255,205,50,50,Direct
3507298,125,0,35,170,135,35,35,Direct
3507584,350,130,40,375,335,40,40,Direct
3507691,225,45,50,240,190,50,50,Direct
3504090,175,15,35,150,115,35,35,Direct
3507891,250,40,50,260,210,50,50,Direct
3507991,150,5,35,150,115,35,35,Direct
3431783,75,0,35,160,125,35,35,Direct
3508134,225,80,35,150,115,35,35,Direct
3508277,50,0,50,270,220,50,50,Direct
3508863,75,0,35,155,120,35,35,Direct
3508920,325,85,35,180,145,35,35,Direct
3509313,200,35,35,135,100,35,35,Direct
3509456,200,10,50,265,215,50,50,Direct
3509506,200,30,50,325,275,50,50,Direct
3509563,175,5,15,70,55,15,15,Direct
3509606,100,0,35,235,200,35,35,Direct
3509699,225,50,35,185,150,35,35,Direct
3509813,325,95,40,245,205,40,40,Direct
3509913,200,30,35,190,155,35,35,Direct
3508670,75,0,20,25,5,20,20,Direct
3530491,175,5,35,185,150,35,35,Direct
3512992,175,15,35,140,105,35,35,Direct
3532146,175,15,50,235,185,50,50,Direct
3532231,200,30,50,235,185,50,50,Direct
3532312,175,15,35,180,145,35,35,Direct
3532797,150,0,35,145,110,35,35,Direct
3532899,250,55,50,325,275,50,50,Direct
3532967,275,55,35,275,240,35,35,Direct
3533082,75,0,35,150,115,35,35,Direct
3533201,375,155,35,285,250,35,35,Direct
3533299,150,5,35,180,145,35,35,Direct
3533567,150,0,35,155,120,35,35,Direct
3533669,175,10,35,135,100,35,35,Direct
3533933,225,45,35,125,90,35,35,Direct
3534201,175,5,50,290,240,50,50,Direct
3494042,475,190,250,565,315,250,250,Direct
3534537,300,85,20,160,140,20,20,Direct
3534788,200,30,60,150,90,60,60,Direct
3534822,75,0,50,275,225,50,50,Direct
3535907,175,10,35,190,155,35,35,Direct
3535958,325,85,50,225,175,50,50,Direct
3536141,50,0,20,160,140,20,20,Direct
3536243,275,75,20,130,110,20,20,Direct
3536273,200,30,35,185,150,35,35,Direct
3536324,500,195,150,380,230,150,150,Direct
3536375,325,105,50,275,225,50,50,Direct
3536473,175,10,35,155,120,35,35,Direct
3536792,100,0,35,245,210,35,35,Direct
3536911,200,20,35,190,155,35,35,Direct
3536975,200,35,35,140,105,35,35,Direct
3537026,500,195,55,410,355,55,55,Direct
3537460,150,0,20,35,15,20,20,Direct
3537579,100,0,15,70,55,15,15,Direct
3537945,150,0,35,180,145,35,35,Direct
3538315,200,25,20,190,170,20,20,Direct
3538549,200,40,50,215,165,50,50,Direct
3538562,175,15,35,165,130,35,35,Direct
3538796,250,50,35,145,110,35,35,Direct
3538932,100,0,35,150,115,35,35,Direct
3539264,425,145,50,375,325,50,50,Direct
3539315,200,30,35,195,160,35,35,Direct
3539349,350,100,35,180,145,35,35,Direct
3539383,175,10,40,220,180,40,40,Direct
3539468,50,0,20,140,120,20,20,Direct
3539702,100,0,50,220,170,50,50,Direct
3540136,100,0,50,280,230,50,50,Direct
3540170,200,55,35,235,200,35,35,Direct
3526598,125,0,34,149,115,34,34,Direct
3540485,225,45,35,185,150,35,35,Direct
3540502,225,30,35,185,150,35,35,Direct
3540519,100,0,35,140,105,35,35,Direct
3540821,100,0,35,250,215,35,35,Direct
3540872,250,45,35,155,120,35,35,Direct
3492604,175,5,35,185,150,35,35,Direct
3520190,150,0,50,185,135,50,50,Direct
3520339,150,5,35,180,145,35,35,Direct
3520607,325,95,35,195,160,35,35,Direct
3520590,325,105,20,185,165,20,20,Direct
3520790,225,35,50,250,200,50,50,Direct
3520825,125,0,35,115,80,35,35,Direct
3520922,150,0,34,119,85,34,34,Direct
3520926,225,15,50,220,170,50,50,Direct
3520939,125,0,50,250,200,50,50,Direct
3520990,200,30,50,270,220,50,50,Direct
3521343,200,30,100,200,100,100,100,Direct
3521390,200,25,35,105,70,35,35,Direct
3521394,250,55,35,250,215,35,35,Direct
3521544,100,0,35,190,155,35,35,Direct
3521625,100,0,20,170,150,20,20,Direct
3521761,900,480,80,790,710,80,80,Direct
3521943,175,10,35,150,115,35,35,Direct
3522025,250,50,35,135,100,35,35,Direct
3522462,250,65,75,320,245,75,75,Direct
3522479,175,15,25,90,65,25,25,Direct
3522679,200,25,35,145,110,35,35,Direct
3517982,50,0,25,70,45,25,25,Direct
3522965,100,0,35,140,105,35,35,Direct
3522662,575,255,75,375,300,75,75,Direct
3523029,200,25,25,95,70,25,25,Direct
3523212,75,0,35,180,145,35,35,Direct
3523229,75,0,35,150,115,35,35,Direct
3523433,100,0,55,300,245,55,55,Direct
3523479,175,10,35,160,125,35,35,Direct
3523998,250,45,20,170,150,20,20,Direct
3502823,375,120,50,255,205,50,50,Direct
3514541,150,5,20,75,55,20,20,Direct
3496089,250,60,20,170,150,20,20,Direct
3524266,175,10,35,175,140,35,35,Direct
3524433,200,30,55,465,410,55,55,Direct
3524569,175,10,50,205,155,50,50,Direct
3524666,175,10,50,275,225,50,50,Direct
3524701,150,0,50,275,225,50,50,Direct
3525037,100,0,35,255,220,35,35,Direct
3525019,275,60,50,270,220,50,50,Direct
3525134,200,5,50,355,305,50,50,Direct
3525151,425,145,50,245,195,50,50,Direct
3525287,200,25,20,115,95,20,20,Direct
3525270,200,35,35,145,110,35,35,Direct
3525351,325,105,50,375,325,50,50,Direct
3525470,350,120,35,160,125,35,35,Direct
3525487,200,25,35,260,225,35,35,Direct
3525538,150,0,35,180,145,35,35,Direct
3525705,175,5,60,195,135,60,60,Direct
3526556,100,0,35,140,105,35,35,Direct
3526738,125,0,35,170,135,35,35,Direct
3526742,350,135,35,185,150,35,35,Direct
3526824,225,35,75,355,280,75,75,Direct
3526891,225,45,35,180,145,35,35,Direct
3526874,175,10,110,440,330,110,110,Direct
3433249,150,0,40,265,225,40,40,Direct
3527509,225,30,25,80,55,25,25,Direct
3527560,350,115,50,220,170,50,50,Direct
3527942,125,0,35,190,155,35,35,Direct
3492009,200,50,35,180,145,35,35,Direct
3466673,450,145,40,360,320,40,40,Direct
3493845,225,45,35,125,90,35,35,Direct
3493945,175,10,35,175,140,35,35,Direct
3494388,200,15,50,250,200,50,50,Direct
3494688,100,0,50,340,290,50,50,Direct
3494881,175,10,35,180,145,35,35,Direct
3494981,175,10,50,175,125,50,50,Direct
3495158,225,55,35,180,145,35,35,Direct
3495324,75,0,20,50,30,20,20,Direct
3495560,250,55,50,200,150,50,50,Direct
3495651,200,10,33,148,115,33,33,Direct
3483719,175,0,35,180,145,35,35,Direct
3478748,100,0,35,185,150,35,35,Direct
3495760,500,195,50,250,200,50,50,Direct
3495994,125,0,20,130,110,20,20,Direct
3496294,300,85,20,160,140,20,20,Direct
3496394,150,0,50,375,325,50,50,Direct
3496396,75,0,50,230,180,50,50,Direct
3496760,325,95,125,500,375,125,125,Direct
3496896,175,15,20,80,60,20,20,Direct
3497130,250,65,50,275,225,50,50,Direct
3497253,200,35,20,170,150,20,20,Direct
3497387,100,0,50,210,160,50,50,Direct
3497466,275,75,75,325,250,75,75,Direct
3497323,225,40,35,185,150,35,35,Direct
3497566,100,0,40,220,180,40,40,Direct
3497589,175,10,35,100,65,35,35,Direct
3498125,175,10,50,200,150,50,50,Direct
3498268,300,80,35,170,135,35,35,Direct
3498368,225,35,25,85,60,25,25,Direct
3498666,100,0,35,160,125,35,35,Direct
3499025,300,70,40,275,235,40,40,Direct
3499068,150,0,20,155,135,20,20,Direct
3499402,100,0,50,250,200,50,50,Direct
3497230,300,90,35,200,165,35,35,Direct
3499931,100,0,35,135,100,35,35,Direct
3500161,175,5,20,120,100,20,20,Direct
3500204,175,20,35,190,155,35,35,Direct
3500540,200,25,35,155,120,35,35,Direct
3500640,400,125,40,205,165,40,40,Direct
3500931,300,85,35,175,140,35,35,Direct
3501140,275,85,35,150,115,35,35,Direct
3501174,175,20,35,160,125,35,35,Direct
3500897,200,25,35,250,215,35,35,Direct
3501374,375,135,35,185,150,35,35,Direct
3501440,275,70,35,155,120,35,35,Direct
3501610,325,105,50,275,225,50,50,Direct
3501669,125,0,60,190,130,60,60,Direct
3561444,200,20,35,170,135,35,35,Direct
3561927,175,10,35,190,155,35,35,Direct
3562563,125,0,35,125,90,35,35,Direct
3562829,75,0,35,235,200,35,35,Direct
3562999,125,0,75,330,255,75,75,Direct
3563163,200,30,60,120,60,60,60,Direct
3563199,200,10,35,155,120,35,35,Direct
3563250,75,0,35,190,155,35,35,Direct
3563816,150,0,35,150,115,35,35,Direct
3563999,225,45,75,345,270,75,75,Direct
3564586,275,45,35,135,100,35,35,Direct
3564886,75,0,35,110,75,35,35,Direct
3564901,100,0,35,225,190,35,35,Direct
3564937,175,5,35,200,165,35,35,Direct
3565437,275,85,20,175,155,20,20,Direct
3565473,300,70,20,150,130,20,20,Direct
3566507,175,10,35,140,105,35,35,Direct
3566860,75,0,10,20,10,10,10,Direct
3566907,150,0,50,210,160,50,50,Direct
3567294,150,5,20,185,165,20,20,Direct
3567545,75,0,35,155,120,35,35,Direct
3567643,200,15,35,180,145,35,35,Direct
3567694,100,0,50,250,200,50,50,Direct
3568330,200,25,50,275,225,50,50,Direct
3547089,375,130,20,185,165,20,20,Direct
3560306,250,45,35,190,155,35,35,Direct
3570068,175,10,35,185,150,35,35,Direct
3570168,175,10,35,170,135,35,35,Direct
3570602,375,130,20,180,160,20,20,Direct
3570704,300,85,50,200,150,50,50,Direct
3570751,175,5,50,200,150,50,50,Direct
3572423,175,10,20,170,150,20,20,Direct
3573040,150,0,20,110,90,20,20,Direct
3573595,150,5,35,185,150,35,35,Direct
3527462,200,35,50,250,200,50,50,Direct
3527653,75,0,60,125,65,60,60,Direct
3527764,325,90,75,305,230,75,75,Direct
3527832,175,10,35,180,145,35,35,Direct
3527891,75,0,35,135,100,35,35,Direct
3524854,75,0,20,130,110,20,20,Direct
3516259,200,25,35,150,115,35,35,Direct
3522114,200,30,35,240,205,35,35,Direct
3528223,175,15,50,275,225,50,50,Direct
3528291,300,75,35,185,150,35,35,Direct
3528389,375,160,50,265,215,50,50,Direct
3528564,125,0,35,140,105,35,35,Direct
3528759,175,10,35,175,140,35,35,Direct
3522416,25,0,35,110,75,35,35,Direct
3528993,425,145,50,250,200,50,50,Direct
3529032,300,85,35,175,140,35,35,Direct
3529291,125,0,50,200,150,50,50,Direct
3529359,200,25,35,190,155,35,35,Direct
3529393,225,35,35,185,150,35,35,Direct
3529436,300,115,35,190,155,35,35,Direct
3529525,175,0,50,220,170,50,50,Direct
3529534,150,0,35,160,125,35,35,Direct
3529802,100,0,35,160,125,35,35,Direct
3529793,200,25,35,180,145,35,35,Direct
3529904,25,0,35,110,75,35,35,Direct
3529895,175,10,20,175,155,20,20,Direct
3529963,250,45,20,140,120,20,20,Direct
3530197,175,15,50,240,190,50,50,Direct
3530640,125,0,50,265,215,50,50,Direct
3530695,50,0,35,100,65,35,35,Direct
3530997,275,55,35,160,125,35,35,Direct
3531006,150,0,35,150,115,35,35,Direct
3531065,100,0,35,190,155,35,35,Direct
3531138,75,0,20,95,75,20,20,Direct
3531133,400,175,50,275,225,50,50,Direct
3531163,125,0,20,110,90,20,20,Direct
3531342,200,20,35,225,190,35,35,Direct
3531576,200,30,25,60,35,25,25,Direct
3531967,100,0,25,60,35,25,25,Direct
3525985,250,65,35,165,130,35,35,Direct
3532703,75,0,35,175,140,35,35,Direct
3532835,200,20,35,175,140,35,35,Direct
3532976,300,85,75,355,280,75,75,Direct
3533469,175,10,35,255,220,35,35,Direct
3533503,200,35,50,225,175,50,50,Direct
3533678,200,35,50,255,205,50,50,Direct
3533912,125,0,35,135,100,35,35,Direct
3534180,175,5,40,220,180,40,40,Direct
3534205,250,40,50,210,160,50,50,Direct
3534716,200,20,35,170,135,35,35,Direct
3534750,550,230,55,400,345,55,55,Direct
3534907,275,55,40,250,210,40,40,Direct
3535277,75,0,35,125,90,35,35,Direct
3535511,75,0,0,5,5,0,0,Direct
3535584,125,0,50,210,160,50,50,Direct
3510363,300,75,35,145,110,35,35,Direct
3510628,50,0,20,140,120,20,20,Direct
3510713,325,85,35,180,145,35,35,Direct
3510863,50,0,20,80,60,20,20,Direct
3494987,100,0,35,165,130,35,35,Direct
3511213,100,0,35,180,145,35,35,Direct
3506284,200,30,20,140,120,20,20,Direct
3511463,325,85,35,190,155,35,35,Direct
3511500,100,0,35,100,65,35,35,Direct
3511513,75,0,50,275,225,50,50,Direct
3511563,100,0,20,120,100,20,20,Direct
3511599,175,10,100,230,130,100,100,Direct
3468280,225,25,50,260,210,50,50,Direct
3495888,250,55,35,135,100,35,35,Direct
3511749,75,0,35,160,125,35,35,Direct
3511864,175,5,50,275,225,50,50,Direct
3512000,175,5,35,175,140,35,35,Direct
3511999,75,0,60,105,45,60,60,Direct
3512185,125,0,35,185,150,35,35,Direct
3512299,200,20,20,140,120,20,20,Direct
3499781,175,15,35,155,120,35,35,Direct
3511650,125,0,35,160,125,35,35,Direct
3512985,225,35,40,200,160,40,40,Direct
3513421,200,30,35,205,170,35,35,Direct
3513522,150,0,20,75,55,20,20,Direct
3486278,125,0,20,90,70,20,20,Direct
3514171,200,15,35,165,130,35,35,Direct
3514271,75,0,20,180,160,20,20,Direct
3514358,175,5,20,170,150,20,20,Direct
3514422,100,0,50,260,210,50,50,Direct
3514522,275,80,50,295,245,50,50,Direct
3514608,375,155,35,255,220,35,35,Direct
3514993,225,45,50,250,200,50,50,Direct
3515058,75,0,35,180,145,35,35,Direct
3515107,250,50,35,190,155,35,35,Direct
3515143,200,15,35,190,155,35,35,Direct
3508305,200,10,50,220,170,50,50,Direct
3515457,300,85,20,170,150,20,20,Direct
3515658,300,85,35,170,135,35,35,Direct
3515693,225,25,35,160,125,35,35,Direct
3515694,350,100,50,275,225,50,50,Direct
3515808,175,15,50,200,150,50,50,Direct
3516179,375,150,75,300,225,75,75,Direct
3516243,50,0,20,50,30,20,20,Direct
3516729,200,30,40,245,205,40,40,Direct
3517030,300,90,50,260,210,50,50,Direct
3517115,325,120,35,185,150,35,35,Direct
3517130,125,0,35,100,65,35,35,Direct
3568919,450,145,50,250,200,50,50,Direct
3569019,125,0,20,75,55,20,20,Direct
3527144,175,0,20,180,160,20,20,Direct
3569426,250,40,50,265,215,50,50,Direct
3569862,225,35,35,135,100,35,35,Direct
3570298,125,0,35,270,235,35,35,Direct
3570398,250,40,50,245,195,50,50,Direct
3570655,50,0,35,170,135,35,35,Direct
3570934,125,0,35,225,190,35,35,Direct
3571164,175,10,35,150,115,35,35,Direct
3571391,175,0,20,95,75,20,20,Direct
3572036,375,155,55,485,430,55,55,Direct
3573163,200,25,50,250,200,50,50,Direct
3573608,225,75,35,135,100,35,35,Direct
3574599,75,0,20,170,150,20,20,Direct
3574708,125,0,35,265,230,35,35,Direct
3521183,225,35,35,190,155,35,35,Direct
3521200,550,265,75,365,290,75,75,Direct
3521249,125,0,35,145,110,35,35,Direct
3521434,75,0,45,155,110,45,45,Direct
3521483,225,30,35,100,65,35,35,Direct
3521536,125,0,35,240,205,35,35,Direct
3520447,225,30,20,80,60,20,20,Direct
3508981,200,30,35,105,70,35,35,Direct
3522570,325,85,35,150,115,35,35,Direct
3522585,300,100,50,285,235,50,50,Direct
3522721,200,35,50,325,275,50,50,Direct
3522770,100,0,20,135,115,20,20,Direct
3522836,275,60,35,180,145,35,35,Direct
3522906,250,40,50,250,200,50,50,Direct
3522936,150,0,60,175,115,60,60,Direct
3523157,150,0,35,140,105,35,35,Direct
3523272,225,35,50,260,210,50,50,Direct
3523306,150,0,50,250,200,50,50,Direct
3523655,175,5,20,140,120,20,20,Direct
3523772,275,85,150,305,155,150,150,Direct
3495462,200,30,35,180,145,35,35,Direct
3524091,225,30,50,220,170,50,50,Direct
3524242,175,0,50,210,160,50,50,Direct
3524342,300,100,35,210,175,35,35,Direct
3524427,175,0,20,180,160,20,20,Direct
3524444,75,0,35,240,205,35,35,Direct
3524491,175,10,50,375,325,50,50,Direct
3524908,225,35,50,325,275,50,50,Direct
3525127,175,25,35,100,65,35,35,Direct
3525142,175,15,35,160,125,35,35,Direct
3525293,75,0,20,75,55,20,20,Direct
3525344,50,0,20,85,65,20,20,Direct
3525393,275,60,35,190,155,35,35,Direct
3525714,125,0,35,150,115,35,35,Direct
3525778,200,30,35,185,150,35,35,Direct
3525929,25,0,35,180,145,35,35,Direct
3526165,50,0,50,210,160,50,50,Direct
3526414,50,0,35,180,145,35,35,Direct
3526650,100,0,35,225,190,35,35,Direct
3526699,75,0,5,10,5,5,5,Direct
3526850,100,0,35,130,95,35,35,Direct
3527216,175,5,35,250,215,35,35,Direct
3527299,200,30,50,155,105,50,50,Direct
3527550,175,5,35,160,125,35,35,Direct
3527901,175,15,35,155,120,35,35,Direct
3528388,100,0,35,225,190,35,35,Direct
3528973,275,75,100,230,130,100,100,Direct
3529022,175,20,50,250,200,50,50,Direct
3529588,175,10,35,100,65,35,35,Direct
3529622,150,0,35,150,115,35,35,Direct
3530258,525,215,50,295,245,50,50,Direct
3530407,325,85,40,200,160,40,40,Direct
3530543,200,25,35,260,225,35,35,Direct
3505336,175,10,35,250,215,35,35,Direct
3505395,100,0,35,155,120,35,35,Direct
3505604,300,90,50,200,150,50,50,Direct
3505736,100,0,35,160,125,35,35,Direct
3505838,175,20,50,230,180,50,50,Direct
3505902,150,0,35,185,150,35,35,Direct
3506038,100,0,35,170,135,35,35,Direct
3506063,250,50,35,170,135,35,35,Direct
3506131,175,15,35,260,225,35,35,Direct
3506229,250,45,40,210,170,40,40,Direct
3506263,225,30,35,110,75,35,35,Direct
3506340,250,75,50,210,160,50,50,Direct
3503255,75,0,35,170,135,35,35,Direct
3506574,475,195,75,310,235,75,75,Direct
3506799,200,35,35,185,150,35,35,Direct
3507233,175,20,50,205,155,50,50,Direct
3495435,175,10,35,170,135,35,35,Direct
3485114,175,10,35,130,95,35,35,Direct
3506438,100,0,35,160,125,35,35,Direct
3507676,200,40,20,180,160,20,20,Direct
3507876,475,170,50,250,200,50,50,Direct
3507910,225,30,50,265,215,50,50,Direct
3507944,200,15,50,250,200,50,50,Direct
3507969,200,25,35,160,125,35,35,Direct
3508237,300,75,50,265,215,50,50,Direct
3508369,175,15,50,225,175,50,50,Direct
3508378,150,0,20,90,70,20,20,Direct
3508437,100,0,35,255,220,35,35,Direct
3508446,200,30,35,190,155,35,35,Direct
3508471,175,5,20,70,50,20,20,Direct
3508637,250,50,20,75,55,20,20,Direct
3509046,600,270,110,450,340,110,110,Direct
3509539,175,10,35,160,125,35,35,Direct
3509582,100,0,50,320,270,50,50,Direct
3509739,100,0,25,90,65,25,25,Direct
3509905,150,5,35,155,120,35,35,Direct
3507974,325,100,35,180,145,35,35,Direct
3510309,100,0,20,120,100,20,20,Direct
3510348,300,85,35,190,155,35,35,Direct
3508144,75,0,35,145,110,35,35,Direct
3510382,325,100,35,190,155,35,35,Direct
3510484,175,10,50,250,200,50,50,Direct
3510675,300,100,35,190,155,35,35,Direct
3510752,100,0,35,190,155,35,35,Direct
3510977,225,30,60,150,90,60,60,Direct
3511250,175,10,20,80,60,20,20,Direct
3511309,175,0,35,250,215,35,35,Direct
3511318,50,0,35,275,240,35,35,Direct
3511811,100,0,35,185,150,35,35,Direct
3511922,325,90,50,205,155,50,50,Direct
3512245,325,130,75,325,250,75,75,Direct
3443559,125,0,35,150,115,35,35,Direct
3512713,200,30,35,200,165,35,35,Direct
3512722,100,0,50,275,225,50,50,Direct
3512956,275,65,50,245,195,50,50,Direct
3512824,125,0,35,225,190,35,35,Direct
3513790,525,220,35,260,225,35,35,Direct
3513960,175,5,25,50,25,25,25,Direct
3514228,300,145,50,265,215,50,50,Direct
3514287,100,0,20,80,60,20,20,Direct
3514385,175,10,20,65,45,20,20,Direct
3514594,125,0,35,115,80,35,35,Direct
3514955,125,0,50,260,210,50,50,Direct
3515028,175,10,50,270,220,50,50,Direct
3515087,100,0,50,265,215,50,50,Direct
3556032,175,10,20,95,75,20,20,Direct
3556232,75,0,35,175,140,35,35,Direct
3556282,25,0,35,125,90,35,35,Direct
3551162,75,0,50,265,215,50,50,Direct
3556750,175,5,35,115,80,35,35,Direct
3557061,250,55,20,130,110,20,20,Direct
3557104,200,20,35,140,105,35,35,Direct
3557418,175,5,35,190,155,35,35,Direct
3557443,100,0,35,175,140,35,35,Direct
3557504,100,0,20,85,65,20,20,Direct
3557597,375,150,50,325,275,50,50,Direct
3557622,100,0,20,170,150,20,20,Direct
3557904,200,30,35,245,210,35,35,Direct
3558240,125,0,50,225,175,50,50,Direct
3558490,100,0,35,185,150,35,35,Direct
3558690,75,0,20,85,65,20,20,Direct
3552299,100,0,35,135,100,35,35,Direct
3558933,125,0,35,175,140,35,35,Direct
3559358,200,35,20,160,140,20,20,Direct
3559494,225,20,20,140,120,20,20,Direct
3509111,75,0,20,110,90,20,20,Direct
3561030,350,130,75,355,280,75,75,Direct
3561048,200,20,35,150,115,35,35,Direct
3561230,100,0,35,175,140,35,35,Direct
3561430,250,50,35,175,140,35,35,Direct
3561716,125,0,35,155,120,35,35,Direct
3561873,200,20,40,275,235,40,40,Direct
3562116,150,5,35,130,95,35,35,Direct
3562327,75,0,25,70,45,25,25,Direct
3562434,275,90,50,215,165,50,50,Direct
3562741,200,30,35,245,210,35,35,Direct
3563370,175,15,35,185,150,35,35,Direct
3538316,200,20,35,285,250,35,35,Direct
3564574,200,20,20,75,55,20,20,Direct
3565174,125,0,75,350,275,75,75,Direct
3565217,350,125,50,290,240,50,50,Direct
3557915,175,10,40,235,195,40,40,Direct
3553567,25,0,35,165,130,35,35,Direct
3565935,200,25,35,165,130,35,35,Direct
3566221,200,15,35,150,115,35,35,Direct
3566192,100,0,50,225,175,50,50,Direct
3566446,75,0,35,150,115,35,35,Direct
3566510,200,20,35,285,250,35,35,Direct
3567153,100,0,35,135,100,35,35,Direct
3567221,75,0,35,175,140,35,35,Direct
3567732,75,0,20,50,30,20,20,Direct
3567914,175,10,50,245,195,50,50,Direct
3568250,200,25,20,85,65,20,20,Direct
3557711,250,0,35,150,115,35,35,Direct
3569011,175,5,50,210,160,50,50,Direct
3570608,100,0,20,165,145,20,20,Direct
3573223,150,0,40,245,205,40,40,Direct
3573755,175,15,35,150,115,35,35,Direct
3573773,100,0,35,150,115,35,35,Direct
3574309,175,15,15,70,55,15,15,Direct
3507931,225,35,40,275,235,40,40,Direct
3508029,75,0,10,20,10,10,10,Direct
3508165,75,0,35,140,105,35,35,Direct
3508450,375,115,50,215,165,50,50,Direct
3508497,200,25,35,190,155,35,35,Direct
3484918,150,5,35,175,140,35,35,Direct
3508667,400,135,75,345,270,75,75,Direct
3508765,50,0,35,190,155,35,35,Direct
3508948,275,70,50,275,225,50,50,Direct
3508982,300,90,20,180,160,20,20,Direct
3509416,200,30,35,190,155,35,35,Direct
3509518,250,40,35,175,140,35,35,Direct
3509786,150,5,20,135,115,20,20,Direct
3510152,75,0,35,215,180,35,35,Direct
3510318,200,25,35,170,135,35,35,Direct
3510305,100,0,50,260,210,50,50,Direct
3494091,150,0,50,230,180,50,50,Direct
3510671,200,30,50,285,235,50,50,Direct
3510905,75,0,35,120,85,35,35,Direct
3511224,75,0,40,220,180,40,40,Direct
3511241,100,0,50,205,155,50,50,Direct
3511322,325,110,40,375,335,40,40,Direct
3511407,250,55,35,260,225,35,35,Direct
3511692,250,75,50,250,200,50,50,Direct
3511709,175,10,35,165,130,35,35,Direct
3512041,200,30,25,95,70,25,25,Direct
3512109,200,10,60,195,135,60,60,Direct
3512177,350,105,50,275,225,50,50,Direct
3512360,200,30,35,125,90,35,35,Direct
3512424,225,45,50,240,190,50,50,Direct
3512560,175,5,20,140,120,20,20,Direct
3501698,75,0,75,315,240,75,75,Direct
3507765,350,125,35,170,135,35,35,Direct
3512190,275,70,50,225,175,50,50,Direct
3512977,375,105,50,230,180,50,50,Direct
3513011,375,120,50,250,200,50,50,Direct
3513109,200,25,35,160,125,35,35,Direct
3491019,0,0,20,130,110,20,20,Direct
3513645,175,5,35,120,85,35,35,Direct
3514198,225,45,35,200,165,35,35,Direct
3514330,200,30,50,230,180,50,50,Direct
3514500,150,0,25,65,40,25,25,Direct
3513713,100,0,40,210,170,40,40,Direct
3514683,200,30,35,260,225,35,35,Direct
3514832,625,345,310,765,455,310,310,Direct
3514866,275,60,50,205,155,50,50,Direct
3515032,275,65,50,285,235,50,50,Direct
3515283,200,30,35,150,115,35,35,Direct
3498171,225,45,33,123,90,33,33,Direct
3515666,75,0,35,140,105,35,35,Direct
3512309,300,70,15,95,80,15,15,Direct
3515887,100,0,35,160,125,35,35,Direct
3515934,200,15,35,225,190,35,35,Direct
3516053,50,0,35,170,135,35,35,Direct
3500494,250,45,35,150,115,35,35,Direct
3506336,175,10,35,155,120,35,35,Direct
3506450,325,90,50,225,175,50,50,Direct
3506867,50,0,35,100,65,35,35,Direct
3505314,175,15,35,155,120,35,35,Direct
3506885,250,45,35,185,150,35,35,Direct
3502659,1125,735,500,1590,1090,500,500,Direct
3507085,175,10,75,335,260,75,75,Direct
3507421,175,5,50,210,160,50,50,Direct
3507654,800,405,65,550,485,65,65,Direct
3507671,100,0,50,265,215,50,50,Direct
3507821,75,0,35,180,145,35,35,Direct
3507957,75,0,50,225,175,50,50,Direct
3508072,275,70,50,205,155,50,50,Direct
3508122,125,0,35,130,95,35,35,Direct
3508322,300,105,50,225,175,50,50,Direct
3508672,175,10,50,375,325,50,50,Direct
3508689,100,0,50,325,275,50,50,Direct
3508926,375,155,35,225,190,35,35,Direct
3509076,350,120,35,185,150,35,35,Direct
3509143,75,0,25,55,30,25,25,Direct
3509258,200,20,50,200,150,50,50,Direct
3509276,250,60,50,280,230,50,50,Direct
3509493,75,0,35,110,75,35,35,Direct
3509812,175,5,35,200,165,35,35,Direct
3510279,225,45,50,230,180,50,50,Direct
3510479,275,85,75,330,255,75,75,Direct
3510561,100,0,35,120,85,35,35,Direct
3510947,200,20,35,150,115,35,35,Direct
3507586,175,0,35,150,115,35,35,Direct
3511165,200,35,35,175,140,35,35,Direct
3511280,250,40,20,180,160,20,20,Direct
3511283,150,0,50,275,225,50,50,Direct
3511415,75,0,50,200,150,50,50,Direct
3511483,175,10,35,180,145,35,35,Direct
3511548,225,40,35,190,155,35,35,Direct
3511747,375,140,35,195,160,35,35,Direct
3511815,75,0,35,185,150,35,35,Direct
3511866,175,10,35,125,90,35,35,Direct
3512351,275,85,50,260,210,50,50,Direct
3512433,175,5,50,250,200,50,50,Direct
3512619,200,30,35,215,180,35,35,Direct
3512769,250,30,60,105,45,60,60,Direct
3513070,450,190,75,330,255,75,75,Direct
3513402,175,15,20,160,140,20,20,Direct
3504528,225,30,35,135,100,35,35,Direct
3497107,100,0,20,85,65,20,20,Direct
3513738,25,0,35,175,140,35,35,Direct
3514556,250,65,35,105,70,35,35,Direct
3514624,275,55,35,170,135,35,35,Direct
3510394,175,10,35,140,105,35,35,Direct
3499651,75,0,25,60,35,25,25,Direct
3515542,200,20,50,375,325,50,50,Direct
3515560,150,0,35,150,115,35,35,Direct
3515645,175,5,50,250,200,50,50,Direct
3515627,150,0,35,160,125,35,35,Direct
3515691,125,0,35,175,140,35,35,Direct
3535745,175,5,50,230,180,50,50,Direct
3535784,225,30,20,145,125,20,20,Direct
3535886,200,35,35,185,150,35,35,Direct
3524747,175,10,35,190,155,35,35,Direct
3535988,225,40,50,210,160,50,50,Direct
3536052,200,30,40,300,260,40,40,Direct
3536354,75,0,35,175,140,35,35,Direct
3536788,100,0,35,140,105,35,35,Direct
3536979,200,40,50,210,160,50,50,Direct
3537056,175,5,35,190,155,35,35,Direct
3537081,325,90,35,285,250,35,35,Direct
3537290,125,0,20,135,115,20,20,Direct
3537826,125,0,20,180,160,20,20,Direct
3494497,150,0,50,200,150,50,50,Direct
3530738,200,30,35,190,155,35,35,Direct
3538183,75,0,35,125,90,35,35,Direct
3538451,175,15,35,140,105,35,35,Direct
3538685,100,0,20,140,120,20,20,Direct
3538694,250,40,35,185,150,35,35,Direct
3538792,250,45,20,190,170,20,20,Direct
3538987,175,5,25,70,45,25,25,Direct
3539128,200,30,35,175,140,35,35,Direct
3539260,75,0,20,95,75,20,20,Direct
3539621,200,35,50,155,105,50,50,Direct
3539221,150,0,25,55,30,25,25,Direct
3539962,175,10,60,150,90,60,60,Direct
3525415,375,125,35,180,145,35,35,Direct
3536111,75,0,40,310,270,40,40,Direct
3540366,100,0,35,185,150,35,35,Direct
3540634,75,0,35,225,190,35,35,Direct
3540659,200,25,35,165,130,35,35,Direct
3540698,75,0,50,220,170,50,50,Direct
3540800,125,0,50,205,155,50,50,Direct
3541068,75,0,35,150,115,35,35,Direct
3541132,100,0,60,190,130,60,60,Direct
3541268,150,0,35,190,155,35,35,Direct
3541336,325,120,75,385,310,75,75,Direct
3541391,75,0,35,100,65,35,35,Direct
3541702,175,10,35,150,115,35,35,Direct
3541829,175,20,20,145,125,20,20,Direct
3541804,75,0,35,180,145,35,35,Direct
3532376,50,0,20,120,100,20,20,Direct
3542034,150,0,35,295,260,35,35,Direct
3542038,200,30,35,180,145,35,35,Direct
3542127,100,0,35,150,115,35,35,Direct
3542170,125,0,35,150,115,35,35,Direct
3542297,100,0,35,125,90,35,35,Direct
3542302,125,0,35,145,110,35,35,Direct
3542931,175,10,35,150,115,35,35,Direct
3542736,100,0,35,105,70,35,35,Direct
3543165,325,115,50,265,215,50,50,Direct
3543297,200,35,50,295,245,50,50,Direct
3526619,150,0,20,30,10,20,20,Direct
3509746,175,10,33,143,110,33,33,Direct
3543472,100,0,20,160,140,20,20,Direct
3543272,275,70,20,170,150,20,20,Direct
3543701,75,0,35,175,140,35,35,Direct
3543706,50,0,35,155,120,35,35,Direct
3543876,175,15,50,310,260,50,50,Direct
3544174,175,5,50,220,170,50,50,Direct
3544467,350,130,75,315,240,75,75,Direct
3541004,300,90,50,275,225,50,50,Direct
3541055,200,20,50,220,170,50,50,Direct
3541238,75,0,50,275,225,50,50,Direct
3541340,125,0,35,255,220,35,35,Direct
3541591,50,0,35,190,155,35,35,Direct
3537396,225,30,35,205,170,35,35,Direct
3541974,100,0,20,70,50,20,20,Direct
3542140,175,5,35,140,105,35,35,Direct
3542289,50,0,50,220,170,50,50,Direct
3542408,200,20,40,250,210,40,40,Direct
3542625,175,0,35,265,230,35,35,Direct
3542659,175,5,50,250,200,50,50,Direct
3480155,100,0,35,155,120,35,35,Direct
3542808,75,0,60,150,90,60,60,Direct
3542991,150,0,50,290,240,50,50,Direct
3543093,150,0,35,190,155,35,35,Direct
3543361,175,5,35,175,140,35,35,Direct
3543527,275,85,50,375,325,50,50,Direct
3543578,275,70,35,125,90,35,35,Direct
3543646,75,0,40,325,285,40,40,Direct
3544029,225,35,35,160,125,35,35,Direct
3544212,75,0,50,275,225,50,50,Direct
3544280,50,0,35,170,135,35,35,Direct
3544565,150,5,35,150,115,35,35,Direct
3515034,325,110,35,175,140,35,35,Direct
3545050,75,0,15,70,55,15,15,Direct
3545084,100,0,35,165,130,35,35,Direct
3545165,50,0,35,215,180,35,35,Direct
3545182,250,50,35,255,220,35,35,Direct
3545216,175,15,35,175,140,35,35,Direct
3545284,100,0,70,230,160,70,70,Direct
3529857,75,0,20,130,110,20,20,Direct
3545782,125,0,50,230,180,50,50,Direct
3545833,75,0,20,90,70,20,20,Direct
3545884,200,10,50,270,220,50,50,Direct
3507631,175,5,20,180,160,20,20,Direct
3545986,275,55,20,85,65,20,20,Direct
3546016,225,60,35,145,110,35,35,Direct
3546301,175,5,35,205,170,35,35,Direct
3546335,125,0,25,90,65,25,25,Direct
3546535,175,15,35,190,155,35,35,Direct
3546654,125,0,35,120,85,35,35,Direct
3546705,350,115,35,190,155,35,35,Direct
3546671,75,0,50,265,215,50,50,Direct
3546786,175,10,35,100,65,35,35,Direct
3546871,125,0,20,80,60,20,20,Direct
3547003,75,0,35,175,140,35,35,Direct
3547356,200,30,50,390,340,50,50,Direct
3547505,125,0,20,160,140,20,20,Direct
3547956,225,45,35,155,120,35,35,Direct
3548743,200,10,20,175,155,20,20,Direct
3532448,150,0,35,185,150,35,35,Direct
3519761,50,0,15,70,55,15,15,Direct
3549258,125,0,35,190,155,35,35,Direct
3549275,150,5,35,125,90,35,35,Direct
3549377,175,5,35,155,120,35,35,Direct
3549696,300,70,35,110,75,35,35,Direct
3549726,200,20,50,250,200,50,50,Direct
3549794,225,25,35,125,90,35,35,Direct
3549913,275,90,35,185,150,35,35,Direct
3550245,100,0,25,80,55,25,25,Direct
3516436,150,0,35,165,130,35,35,Direct
3516602,75,0,35,125,90,35,35,Direct
3516704,200,35,35,130,95,35,35,Direct
3517155,100,0,20,175,155,20,20,Direct
3517257,225,35,50,225,175,50,50,Direct
3498605,200,30,35,175,140,35,35,Direct
3517508,50,0,50,200,150,50,50,Direct
3517772,325,135,50,205,155,50,50,Direct
3518193,300,100,49,244,195,49,49,Direct
3518210,100,0,35,140,105,35,35,Direct
3515785,200,25,35,100,65,35,35,Direct
3518708,200,30,35,290,255,35,35,Direct
3518827,350,135,50,260,210,50,50,Direct
3519027,275,80,50,210,160,50,50,Direct
3519061,425,170,50,250,200,50,50,Direct
3519261,200,20,35,170,135,35,35,Direct
3519278,300,95,50,260,210,50,50,Direct
3519346,375,190,125,510,385,125,125,Direct
3519393,100,0,35,120,85,35,35,Direct
3519495,225,30,20,145,125,20,20,Direct
3520031,225,45,35,260,225,35,35,Direct
3516806,50,0,35,165,130,35,35,Direct
3520784,275,95,50,250,200,50,50,Direct
3516521,200,30,40,275,235,40,40,Direct
3520899,125,0,35,185,150,35,35,Direct
3520950,250,45,35,115,80,35,35,Direct
3521167,250,50,35,115,80,35,35,Direct
3521184,200,30,50,250,200,50,50,Direct
3522086,75,0,35,150,115,35,35,Direct
3522154,175,0,35,260,225,35,35,Direct
3522201,200,25,50,250,200,50,50,Direct
3522235,50,0,35,170,135,35,35,Direct
3522371,325,105,20,140,120,20,20,Direct
3522554,225,30,35,150,115,35,35,Direct
3502881,50,0,35,175,140,35,35,Direct
3522788,175,10,35,125,90,35,35,Direct
3522771,125,0,35,150,115,35,35,Direct
3522822,275,75,50,250,200,50,50,Direct
3522839,200,30,35,185,150,35,35,Direct
3522988,375,170,35,290,255,35,35,Direct
3523056,175,10,35,220,185,35,35,Direct
3522873,200,20,20,150,130,20,20,Direct
3523222,200,40,35,150,115,35,35,Direct
3523371,175,15,50,325,275,50,50,Direct
3523388,50,0,50,250,200,50,50,Direct
3523473,150,5,50,250,200,50,50,Direct
3523507,225,45,35,210,175,35,35,Direct
3510288,100,0,35,225,190,35,35,Direct
3523690,450,170,75,360,285,75,75,Direct
3522320,200,30,35,130,95,35,35,Direct
3524307,250,35,35,225,190,35,35,Direct
3524975,300,80,50,215,165,50,50,Direct
3489564,100,0,35,190,155,35,35,Direct
3525196,275,60,50,235,185,50,50,Direct
3525209,325,110,50,210,160,50,50,Direct
3525226,250,75,20,170,150,20,20,Direct
3525379,200,30,35,145,110,35,35,Direct
3525430,200,25,50,250,200,50,50,Direct
3516849,175,10,35,170,135,35,35,Direct
3516835,350,120,50,235,185,50,50,Direct
3517024,125,0,35,275,240,35,35,Direct
3517053,325,95,50,240,190,50,50,Direct
3517074,175,15,20,125,105,20,20,Direct
3517160,75,0,20,130,110,20,20,Direct
3517278,150,5,35,165,130,35,35,Direct
3517385,175,10,36,161,125,36,36,Direct
3517542,100,0,25,65,40,25,25,Direct
3517546,25,0,35,100,65,35,35,Direct
3517678,100,0,35,105,70,35,35,Direct
3425908,225,30,50,260,210,50,50,Direct
3517903,350,105,50,250,200,50,50,Direct
3518171,200,20,35,105,70,35,35,Direct
3518189,200,10,35,170,135,35,35,Direct
3518253,75,0,50,250,200,50,50,Direct
3518857,175,10,35,135,100,35,35,Direct
3519082,200,35,35,185,150,35,35,Direct
3519257,175,10,35,190,155,35,35,Direct
3519282,125,0,35,140,105,35,35,Direct
3519632,200,25,37,137,100,37,37,Direct
3519775,25,0,35,160,125,35,35,Direct
3519968,250,45,50,280,230,50,50,Direct
3520218,450,145,50,275,225,50,50,Direct
3520375,250,70,35,240,205,35,35,Direct
3520443,425,140,50,345,295,50,50,Direct
3520729,300,70,50,275,225,50,50,Direct
3497240,150,0,20,45,25,20,20,Direct
3521422,200,30,50,240,190,50,50,Direct
3521436,50,0,20,185,165,20,20,Direct
3515295,400,165,75,390,315,75,75,Direct
3521579,200,15,35,180,145,35,35,Direct
3521729,200,30,35,140,105,35,35,Direct
3521754,225,40,50,250,200,50,50,Direct
3521958,225,45,35,150,115,35,35,Direct
3522115,0,0,20,130,110,20,20,Direct
3522172,50,0,35,260,225,35,35,Direct
3522183,275,55,35,195,160,35,35,Direct
3522447,175,0,50,250,200,50,50,Direct
3522440,150,0,25,95,70,25,25,Direct
3522558,25,0,35,100,65,35,35,Direct
3522583,175,20,20,170,150,20,20,Direct
3522651,150,5,50,220,170,50,50,Direct
3519039,100,0,20,75,55,20,20,Direct
3522851,225,30,35,155,120,35,35,Direct
3522958,375,120,50,220,170,50,50,Direct
3523201,200,15,35,165,130,35,35,Direct
3523251,200,20,35,290,255,35,35,Direct
3523376,175,0,20,170,150,20,20,Direct
3523519,200,25,50,250,200,50,50,Direct
3523537,125,0,60,110,50,60,60,Direct
3523644,175,10,50,220,170,50,50,Direct
3523787,200,30,20,140,120,20,20,Direct
3523844,175,10,60,130,70,60,60,Direct
3522601,150,0,20,170,150,20,20,Direct
3524137,200,55,20,80,60,20,20,Direct
3524187,200,15,35,150,115,35,35,Direct
3524244,200,30,35,195,160,35,35,Direct
3518370,350,105,20,140,120,20,20,Direct
3545135,175,10,60,175,115,60,60,Direct
3543204,250,50,35,185,150,35,35,Direct
3545271,225,60,50,250,200,50,50,Direct
3545344,175,0,20,190,170,20,20,Direct
3545412,125,0,50,205,155,50,50,Direct
3545437,225,50,50,285,235,50,50,Direct
3545539,175,10,20,90,70,20,20,Direct
3545671,225,25,60,175,115,60,60,Direct
3523777,175,5,50,225,175,50,50,Direct
3545680,75,0,35,105,70,35,35,Direct
3545714,275,60,50,225,175,50,50,Direct
3543263,200,15,25,75,50,25,25,Direct
3545880,125,0,35,140,105,35,35,Direct
3546348,325,90,50,225,175,50,50,Direct
3546012,250,65,35,160,125,35,35,Direct
3546573,125,0,35,120,85,35,35,Direct
3546709,175,5,20,95,75,20,20,Direct
3547109,175,5,50,275,225,50,50,Direct
3547284,175,10,65,200,135,65,65,Direct
3547241,275,85,50,245,195,50,50,Direct
3547416,175,10,35,170,135,35,35,Direct
3547543,325,85,35,220,185,35,35,Direct
3548054,375,140,35,230,195,35,35,Direct
3548109,150,0,20,140,120,20,20,Direct
3548113,150,0,35,150,115,35,35,Direct
3548377,250,50,15,70,55,15,15,Direct
3548552,300,140,50,275,225,50,50,Direct
3548620,200,10,25,90,65,25,25,Direct
3548913,250,55,50,375,325,50,50,Direct
3549279,175,15,50,255,205,50,50,Direct
3549951,100,0,50,275,225,50,50,Direct
3550185,100,0,35,160,125,35,35,Direct
3550526,250,50,35,190,155,35,35,Direct
3550585,200,15,35,185,150,35,35,Direct
3550717,375,130,35,170,135,35,35,Direct
3551126,125,0,20,140,120,20,20,Direct
3551662,75,0,35,240,205,35,35,Direct
3551696,225,45,35,140,105,35,35,Direct
3551730,275,65,50,225,175,50,50,Direct
3551964,125,0,35,160,125,35,35,Direct
3552023,50,0,20,95,75,20,20,Direct
3552296,250,65,50,270,220,50,50,Direct
3471165,150,0,20,85,65,20,20,Direct
3552891,225,80,35,190,155,35,35,Direct
3553125,450,145,35,190,155,35,35,Direct
3553134,175,5,40,235,195,40,40,Direct
3553202,100,0,20,95,75,20,20,Direct
3503798,200,25,20,130,110,20,20,Direct
3553725,100,0,35,170,135,35,35,Direct
3553968,300,85,20,145,125,20,20,Direct
3554227,100,0,20,160,140,20,20,Direct
3554368,175,15,50,220,170,50,50,Direct
3554627,175,0,50,255,205,50,50,Direct
3554670,250,55,35,190,155,35,35,Direct
3554704,250,65,75,320,245,75,75,Direct
3555070,200,15,35,100,65,35,35,Direct
3518551,125,0,35,270,235,35,35,Direct
3518666,175,10,35,150,115,35,35,Direct
3518752,575,270,50,390,340,50,50,Direct
3519037,300,90,50,260,210,50,50,Direct
3519352,175,15,20,110,90,20,20,Direct
3519688,200,30,35,190,155,35,35,Direct
3519787,175,5,35,150,115,35,35,Direct
3519823,175,15,60,115,55,60,60,Direct
3520073,200,55,35,190,155,35,35,Direct
3520173,100,0,50,230,180,50,50,Direct
3520424,225,75,35,185,150,35,35,Direct
3520673,150,0,35,245,210,35,35,Direct
3521259,200,30,35,150,115,35,35,Direct
3521274,175,10,100,250,150,100,100,Direct
3521359,125,0,50,235,185,50,50,Direct
3521374,475,170,50,250,200,50,50,Direct
3521895,125,0,35,105,70,35,35,Direct
3521960,225,35,20,140,120,20,20,Direct
3522146,675,355,55,430,375,55,55,Direct
3522295,175,10,15,70,55,15,15,Direct
3522645,175,5,50,260,210,50,50,Direct
3522746,150,5,50,250,200,50,50,Direct
3522731,225,45,75,350,275,75,75,Direct
3515643,100,0,50,245,195,50,50,Direct
3522881,200,25,35,145,110,35,35,Direct
3522931,175,10,20,160,140,20,20,Direct
3522945,100,0,20,80,60,20,20,Direct
3522996,225,40,50,345,295,50,50,Direct
3523096,200,40,35,180,145,35,35,Direct
3433569,175,15,25,65,40,25,25,Direct
3523146,50,0,15,70,55,15,15,Direct
3523196,200,30,37,157,120,37,37,Direct
3478776,150,0,50,250,200,50,50,Direct
3523296,175,5,50,270,220,50,50,Direct
3523331,150,0,20,160,140,20,20,Direct
3523382,150,0,50,275,225,50,50,Direct
3523731,175,5,20,140,120,20,20,Direct
3500068,250,50,35,150,115,35,35,Direct
3520224,275,70,35,270,235,35,35,Direct
3524167,200,20,50,260,210,50,50,Direct
3524181,350,120,50,270,220,50,50,Direct
3524318,350,135,35,190,155,35,35,Direct
3524332,150,5,35,140,105,35,35,Direct
3524382,150,0,35,155,120,35,35,Direct
3524667,275,85,20,140,120,20,20,Direct
3524817,150,0,50,250,200,50,50,Direct
3524867,25,0,20,130,110,20,20,Direct
3525053,225,35,35,160,125,35,35,Direct
3525104,250,45,35,160,125,35,35,Direct
3525103,225,25,35,250,215,35,35,Direct
3525553,125,0,50,220,170,50,50,Direct
3525653,200,25,35,190,155,35,35,Direct
3525753,225,30,50,210,160,50,50,Direct
3515287,50,0,35,160,125,35,35,Direct
3514053,100,0,35,190,155,35,35,Direct
3494831,325,110,35,195,160,35,35,Direct
3515589,100,0,35,180,145,35,35,Direct
3515632,250,65,35,155,120,35,35,Direct
3515657,350,105,50,260,210,50,50,Direct
3515789,175,5,20,175,155,20,20,Direct
3515832,75,0,50,250,200,50,50,Direct
3516066,125,0,35,200,165,35,35,Direct
3516100,150,0,35,100,65,35,35,Direct
3516130,50,0,50,205,155,50,50,Direct
3516232,325,120,50,250,200,50,50,Direct
3516491,225,45,35,150,115,35,35,Direct
3516700,75,0,35,180,145,35,35,Direct
3516857,200,25,60,130,70,60,60,Direct
3517134,100,0,35,150,115,35,35,Direct
3517125,175,10,20,170,150,20,20,Direct
3517168,125,0,35,160,125,35,35,Direct
3517261,125,0,35,170,135,35,35,Direct
3517325,100,0,20,140,120,20,20,Direct
3517559,325,80,50,240,190,50,50,Direct
3424405,175,10,20,75,55,20,20,Direct
3517670,50,0,20,80,60,20,20,Direct
3517827,100,0,100,250,150,100,100,Direct
3517929,175,10,35,190,155,35,35,Direct
3517938,200,25,35,165,130,35,35,Direct
3517997,100,0,25,60,35,25,25,Direct
3518163,250,65,35,160,125,35,35,Direct
3518172,175,0,35,190,155,35,35,Direct
3518236,200,20,35,140,105,35,35,Direct
3518338,225,35,50,200,150,50,50,Direct
3518363,125,0,20,75,55,20,20,Direct
3518538,150,0,50,250,200,50,50,Direct
3518640,400,175,35,280,245,35,35,Direct
3518763,100,0,15,70,55,15,15,Direct
3518908,200,30,50,260,210,50,50,Direct
3518963,150,5,35,175,140,35,35,Direct
3519108,325,115,52,222,170,52,52,Direct
3519231,100,0,35,105,70,35,35,Direct
3519367,100,0,20,150,130,20,20,Direct
3519542,175,0,35,125,90,35,35,Direct
3519810,75,0,35,160,125,35,35,Direct
3520278,175,10,50,210,160,50,50,Direct
3520401,125,0,35,145,110,35,35,Direct
3520844,350,150,75,325,250,75,75,Direct
3520903,150,0,35,140,105,35,35,Direct
3520971,375,120,60,195,135,60,60,Direct
3521439,50,0,35,180,145,35,35,Direct
3521546,175,0,35,200,165,35,35,Direct
3521916,175,15,20,170,150,20,20,Direct
3521946,125,0,20,160,140,20,20,Direct
3522175,475,170,50,285,235,50,50,Direct
3522248,175,10,35,120,85,35,35,Direct
3522375,250,50,75,345,270,75,75,Direct
3522384,275,65,50,210,160,50,50,Direct
3528228,125,0,50,220,170,50,50,Direct
3528777,200,25,35,150,115,35,35,Direct
3528814,125,0,20,30,10,20,20,Direct
3528878,475,165,50,225,175,50,50,Direct
3529632,200,30,75,310,235,75,75,Direct
3529763,75,0,35,160,125,35,35,Direct
3529899,100,0,35,265,230,35,35,Direct
3529981,175,10,50,250,200,50,50,Direct
3530100,200,25,50,200,150,50,50,Direct
3529381,150,0,35,145,110,35,35,Direct
3530499,100,0,35,250,215,35,35,Direct
3530632,225,50,60,150,90,60,60,Direct
3530750,125,0,20,185,165,20,20,Direct
3531018,425,120,35,175,140,35,35,Direct
3531303,175,5,10,20,10,10,10,Direct
3531371,225,45,20,160,140,20,20,Direct
3531436,250,50,50,225,175,50,50,Direct
3531503,150,0,35,100,65,35,35,Direct
3532090,200,30,75,355,280,75,75,Direct
3532104,250,55,50,275,225,50,50,Direct
3532290,75,0,50,240,190,50,50,Direct
3532558,100,0,35,160,125,35,35,Direct
3532504,300,100,50,220,170,50,50,Direct
3532758,175,5,35,135,100,35,35,Direct
3492949,25,0,35,260,225,35,35,Direct
3512719,200,25,25,85,60,25,25,Direct
3533226,100,0,50,220,170,50,50,Direct
3533661,150,0,35,125,90,35,35,Direct
3533861,325,105,35,190,155,35,35,Direct
3533925,175,15,35,250,215,35,35,Direct
3533958,350,105,20,190,170,20,20,Direct
3534179,125,0,35,200,165,35,35,Direct
3534026,375,135,50,250,200,50,50,Direct
3534226,175,10,25,70,45,25,25,Direct
3534461,200,10,50,210,160,50,50,Direct
3535162,125,0,35,180,145,35,35,Direct
3535197,75,0,35,160,125,35,35,Direct
3517349,200,25,35,135,100,35,35,Direct
3529564,200,30,35,170,135,35,35,Direct
3535780,250,60,35,185,150,35,35,Direct
3535915,150,0,35,135,100,35,35,Direct
3526138,50,0,35,210,175,35,35,Direct
3536465,300,85,20,160,140,20,20,Direct
3536583,175,15,100,230,130,100,100,Direct
3536733,250,45,50,275,225,50,50,Direct
3536784,125,0,25,85,60,25,25,Direct
3536852,125,0,35,170,135,35,35,Direct
3536902,175,5,35,170,135,35,35,Direct
3537120,75,0,35,160,125,35,35,Direct
3538941,125,0,20,115,95,20,20,Direct
3538992,125,0,35,150,115,35,35,Direct
3539442,175,25,35,180,145,35,35,Direct
3539524,200,10,50,250,200,50,50,Direct
3539609,175,20,50,280,230,50,50,Direct
3539727,175,15,50,275,225,50,50,Direct
3539860,200,25,50,280,230,50,50,Direct
3539927,175,0,20,185,165,20,20,Direct
3523130,150,0,35,250,215,35,35,Direct
3510399,200,35,35,275,240,35,35,Direct
3510549,200,15,50,200,150,50,50,Direct
3511235,275,85,60,130,70,60,60,Direct
3511292,225,45,60,110,50,60,60,Direct
3511392,275,60,35,135,100,35,35,Direct
3511492,575,280,50,350,300,50,50,Direct
3486892,175,15,60,195,135,60,60,Direct
3511571,175,10,50,250,200,50,50,Direct
3511728,50,0,25,65,40,25,25,Direct
3511971,75,0,35,225,190,35,35,Direct
3512121,200,15,35,205,170,35,35,Direct
3512271,75,0,35,150,115,35,35,Direct
3512421,150,0,35,195,160,35,35,Direct
3512757,250,65,50,275,225,50,50,Direct
3513157,175,10,35,140,105,35,35,Direct
3513300,200,25,50,250,200,50,50,Direct
3513350,350,105,50,275,225,50,50,Direct
3504383,250,60,35,185,150,35,35,Direct
3510542,100,0,35,190,155,35,35,Direct
3513807,125,0,35,160,125,35,35,Direct
3513907,150,0,40,260,220,40,40,Direct
3514100,75,0,35,150,115,35,35,Direct
3514236,375,140,55,410,355,55,55,Direct
3514386,100,0,35,225,190,35,35,Direct
3514493,225,45,50,270,220,50,50,Direct
3514586,175,15,50,260,210,50,50,Direct
3514679,275,75,35,160,125,35,35,Direct
3514829,250,40,60,195,135,60,60,Direct
3514786,200,25,50,270,220,50,50,Direct
3515529,350,105,75,355,280,75,75,Direct
3515779,125,0,30,140,110,30,30,Direct
3515922,175,5,35,145,110,35,35,Direct
3516115,175,5,20,155,135,20,20,Direct
3516172,125,0,100,230,130,100,100,Direct
3516208,275,120,40,220,180,40,40,Direct
3516308,175,20,20,160,140,20,20,Direct
3516401,150,5,50,275,225,50,50,Direct
3516715,125,0,35,145,110,35,35,Direct
3516765,75,0,35,150,115,35,35,Direct
3516858,75,0,35,225,190,35,35,Direct
3517201,50,0,15,45,30,15,15,Direct
3517351,175,10,35,175,140,35,35,Direct
3517437,100,0,50,250,200,50,50,Direct
3517487,125,0,35,260,225,35,35,Direct
3517601,200,25,35,180,145,35,35,Direct
3517701,225,30,35,195,160,35,35,Direct
3517780,75,0,50,260,210,50,50,Direct
3517937,275,50,75,300,225,75,75,Direct
3517980,100,0,35,150,115,35,35,Direct
3517994,150,0,35,135,100,35,35,Direct
3518094,100,0,35,250,215,35,35,Direct
3518180,300,80,35,150,115,35,35,Direct
3518537,175,5,35,225,190,35,35,Direct
3509906,50,0,20,170,150,20,20,Direct
3517669,175,10,35,190,155,35,35,Direct
3517719,250,45,35,210,175,35,35,Direct
3517855,150,0,50,205,155,50,50,Direct
3518255,325,90,20,180,160,20,20,Direct
3518298,25,0,35,225,190,35,35,Direct
3518319,150,5,50,375,325,50,50,Direct
3518312,275,65,50,260,210,50,50,Direct
3518405,75,0,50,210,160,50,50,Direct
3518648,325,105,35,180,145,35,35,Direct
3518612,100,0,35,190,155,35,35,Direct
3518705,125,0,50,275,225,50,50,Direct
3519005,200,10,50,220,170,50,50,Direct
3519241,100,0,20,140,120,20,20,Direct
3519341,225,30,35,185,150,35,35,Direct
3519434,50,0,35,150,115,35,35,Direct
3519541,75,0,35,150,115,35,35,Direct
3519648,275,90,35,155,120,35,35,Direct
3519684,150,0,20,25,5,20,20,Direct
3519941,350,130,50,325,275,50,50,Direct
3520134,125,0,35,150,115,35,35,Direct
3520241,475,160,75,300,225,75,75,Direct
3520370,150,5,20,160,140,20,20,Direct
3520470,125,0,50,250,200,50,50,Direct
3520477,175,10,40,360,320,40,40,Direct
3520734,200,15,35,190,155,35,35,Direct
3520870,125,0,35,250,215,35,35,Direct
3520920,100,0,35,150,115,35,35,Direct
3521027,125,0,40,215,175,40,40,Direct
3521127,100,0,50,260,210,50,50,Direct
3521370,75,0,25,80,55,25,25,Direct
3521406,400,135,50,250,200,50,50,Direct
3521656,50,0,35,170,135,35,35,Direct
3522006,250,70,50,375,325,50,50,Direct
3522056,75,0,20,75,55,20,20,Direct
3522499,175,10,15,70,55,15,15,Direct
3522992,175,15,35,140,105,35,35,Direct
3522999,225,45,50,220,170,50,50,Direct
3523092,225,60,50,250,200,50,50,Direct
3523128,450,170,35,290,255,35,35,Direct
3523278,100,0,25,65,40,25,25,Direct
3523528,200,20,35,145,110,35,35,Direct
3523585,375,140,50,295,245,50,50,Direct
3523642,225,35,50,275,225,50,50,Direct
3523192,250,70,35,160,125,35,35,Direct
3517169,175,15,35,155,120,35,35,Direct
3515061,50,0,35,140,105,35,35,Direct
3524214,275,55,35,125,90,35,35,Direct
3524228,200,30,25,60,35,25,25,Direct
3524807,25,0,50,375,325,50,50,Direct
3524907,350,135,50,275,225,50,50,Direct
3525300,200,25,35,185,150,35,35,Direct
3525307,300,75,20,145,125,20,20,Direct
3525350,100,0,20,140,120,20,20,Direct
3525607,300,80,55,405,350,55,55,Direct
3526093,125,0,20,120,100,20,20,Direct
3526136,100,0,35,155,120,35,35,Direct
3526643,200,25,50,220,170,50,50,Direct
3526786,50,0,40,285,245,40,40,Direct
3526779,100,0,20,85,65,20,20,Direct
3527043,75,0,25,60,35,25,25,Direct
3526586,125,0,15,70,55,15,15,Direct
3527186,200,15,50,280,230,50,50,Direct
3550296,175,10,50,200,150,50,50,Direct
3550547,250,65,40,265,225,40,40,Direct
3550530,150,0,60,135,75,60,60,Direct
3550564,175,10,50,210,160,50,50,Direct
3550479,175,15,35,140,105,35,35,Direct
3550883,275,65,50,230,180,50,50,Direct
3551300,175,10,35,100,65,35,35,Direct
3551334,325,105,40,235,195,40,40,Direct
3551398,275,65,35,155,120,35,35,Direct
3551517,375,170,35,260,225,35,35,Direct
3551534,125,0,35,170,135,35,35,Direct
3551683,125,0,35,135,100,35,35,Direct
3552002,175,15,35,170,135,35,35,Direct
3552100,250,50,35,195,160,35,35,Direct
3552219,125,0,20,90,70,20,20,Direct
3552402,250,65,35,150,115,35,35,Direct
3552487,150,0,35,105,70,35,35,Direct
3552521,50,0,35,100,65,35,35,Direct
3547454,200,20,35,255,220,35,35,Direct
3553355,200,15,50,300,250,50,50,Direct
3553453,100,0,50,235,185,50,50,Direct
3553572,300,70,50,275,225,50,50,Direct
3553640,175,5,35,160,125,35,35,Direct
3553772,75,0,35,185,150,35,35,Direct
3554342,225,30,20,75,55,20,20,Direct
3554457,50,0,50,275,225,50,50,Direct
3554542,100,0,50,230,180,50,50,Direct
3554576,200,20,50,265,215,50,50,Direct
3554606,150,0,50,250,200,50,50,Direct
3555010,50,0,36,136,100,36,36,Direct
3555461,225,45,50,230,180,50,50,Direct
3555793,275,95,20,140,120,20,20,Direct
3547756,175,10,35,200,165,35,35,Direct
3545650,175,10,35,150,115,35,35,Direct
3556899,125,0,45,145,100,45,45,Direct
3557716,125,0,35,160,125,35,35,Direct
3557733,125,0,35,140,105,35,35,Direct
3557750,125,0,35,140,105,35,35,Direct
3557818,200,15,25,80,55,25,25,Direct
3557852,125,0,50,265,215,50,50,Direct
3558099,100,0,50,225,175,50,50,Direct
3558252,150,5,35,165,130,35,35,Direct
3558537,225,30,50,275,225,50,50,Direct
3558669,125,0,35,165,130,35,35,Direct
3559269,425,120,50,250,200,50,50,Direct
3559588,75,0,35,150,115,35,35,Direct
3559690,175,15,20,140,120,20,20,Direct
3559805,175,15,20,140,120,20,20,Direct
3559941,150,5,20,180,160,20,20,Direct
3560524,225,25,35,185,150,35,35,Direct
3560741,175,10,50,220,170,50,50,Direct
3560894,25,0,20,190,170,20,20,Direct
3560941,100,0,50,220,170,50,50,Direct
3561392,25,0,20,40,20,20,20,Direct
3561579,200,15,35,185,150,35,35,Direct
3561911,300,75,40,250,210,40,40,Direct
3561996,100,0,35,135,100,35,35,Direct
3550866,250,65,35,195,160,35,35,Direct
3445310,75,0,35,175,140,35,35,Direct
3563315,50,0,35,185,150,35,35,Direct
3563451,100,0,35,160,125,35,35,Direct
3563698,250,60,35,295,260,35,35,Direct
3564051,300,70,20,180,160,20,20,Direct
3564136,100,0,35,150,115,35,35,Direct
3555206,100,0,20,65,45,20,20,Direct
3555465,250,50,75,300,225,75,75,Direct
3555572,150,0,50,275,225,50,50,Direct
3555606,100,0,50,220,170,50,50,Direct
3555976,125,0,25,70,45,25,25,Direct
3452751,100,0,35,165,130,35,35,Direct
3557010,150,5,35,135,100,35,35,Direct
3557235,175,10,40,230,190,40,40,Direct
3557478,175,10,50,275,225,50,50,Direct
3557571,200,20,35,190,155,35,35,Direct
3557903,350,120,50,215,165,50,50,Direct
3558039,150,0,35,135,100,35,35,Direct
3558307,75,0,20,170,150,20,20,Direct
3558371,200,30,40,250,210,40,40,Direct
3558546,75,0,40,100,60,40,40,Direct
3559418,150,0,35,175,140,35,35,Direct
3559575,150,0,20,165,145,20,20,Direct
3559686,200,25,35,170,135,35,35,Direct
3559745,100,0,50,310,260,50,50,Direct
3560179,250,45,50,225,175,50,50,Direct
3560486,100,0,40,220,180,40,40,Direct
3560588,250,45,35,155,120,35,35,Direct
3560779,200,25,35,185,150,35,35,Direct
3485448,200,30,20,130,110,20,20,Direct
3561115,175,10,60,120,60,60,60,Direct
3561558,50,0,35,150,115,35,35,Direct
3561583,100,0,25,55,30,25,25,Direct
3561690,50,0,35,160,125,35,35,Direct
3561749,400,155,50,250,200,50,50,Direct
3562417,175,10,20,75,55,20,20,Direct
3562860,125,0,50,230,180,50,50,Direct
3562962,150,0,35,190,155,35,35,Direct
3563430,225,45,20,160,140,20,20,Direct
3563655,200,40,20,140,120,20,20,Direct
3564230,125,0,35,115,80,35,35,Direct
3564264,175,10,20,75,55,20,20,Direct
3498986,75,0,35,100,65,35,35,Direct
3564625,375,140,280,645,365,280,280,Direct
3564689,100,0,50,215,165,50,50,Direct
3564732,200,25,35,295,260,35,35,Direct
3564898,300,95,50,225,175,50,50,Direct
3565298,125,0,35,160,125,35,35,Direct
3565634,200,25,35,190,155,35,35,Direct
3565727,400,160,70,265,195,70,70,Direct
3566127,300,75,35,140,105,35,35,Direct
3566259,225,40,50,210,160,50,50,Direct
3566293,300,100,50,285,235,50,50,Direct
3566638,225,35,35,190,155,35,35,Direct
3568340,175,10,20,130,110,20,20,Direct
3568408,100,0,35,125,90,35,35,Direct
3568842,175,10,50,240,190,50,50,Direct
3569076,100,0,35,230,195,35,35,Direct
3569242,200,30,20,140,120,20,20,Direct
3569267,325,130,50,195,145,50,50,Direct
3569510,125,0,50,200,150,50,50,Direct
3569705,225,0,35,100,65,35,35,Direct
3570212,300,80,50,220,170,50,50,Direct
3491221,225,40,40,210,170,40,40,Direct
3572888,125,0,20,75,55,20,20,Direct
3572922,50,0,35,155,120,35,35,Direct
3515959,250,65,50,275,225,50,50,Direct
3516010,300,85,50,275,225,50,50,Direct
3516160,225,40,35,250,215,35,35,Direct
3516163,175,5,36,176,140,36,36,Direct
3516245,225,45,60,160,100,60,60,Direct
3516360,250,45,35,235,200,35,35,Direct
3516445,325,85,35,195,160,35,35,Direct
3517031,175,5,35,125,90,35,35,Direct
3517028,300,115,50,260,210,50,50,Direct
3516109,175,5,40,200,160,40,40,Direct
3517163,100,0,50,270,220,50,50,Direct
3517496,300,80,35,170,135,35,35,Direct
3517513,250,55,35,280,245,35,35,Direct
3517882,75,0,20,170,150,20,20,Direct
3518768,225,35,50,270,220,50,50,Direct
3518785,125,0,20,190,170,20,20,Direct
3519321,100,0,50,210,160,50,50,Direct
3519435,200,30,20,190,170,20,20,Direct
3519703,75,0,35,145,110,35,35,Direct
3512466,300,85,20,170,150,20,20,Direct
3520104,225,40,35,100,65,35,35,Direct
3520154,225,25,35,265,230,35,35,Direct
3520440,75,0,20,140,120,20,20,Direct
3520772,325,85,35,185,150,35,35,Direct
3520775,200,15,35,245,210,35,35,Direct
3520908,175,10,20,180,160,20,20,Direct
3521107,150,0,35,155,120,35,35,Direct
3521307,225,25,35,190,155,35,35,Direct
3521125,325,105,50,275,225,50,50,Direct
3521257,175,10,35,135,100,35,35,Direct
3521308,125,0,50,250,200,50,50,Direct
3521457,275,60,50,250,200,50,50,Direct
3521575,75,0,35,150,115,35,35,Direct
3520257,100,0,35,260,225,35,35,Direct
3522129,200,30,35,105,70,35,35,Direct
3510530,175,10,40,290,250,40,40,Direct
3522379,150,0,35,170,135,35,35,Direct
3522630,150,0,20,105,85,20,20,Direct
3522711,400,175,75,325,250,75,75,Direct
3522779,225,30,20,170,150,20,20,Direct
3523098,175,20,20,170,150,20,20,Direct
3523179,175,10,20,80,60,20,20,Direct
3523265,75,0,20,35,15,20,20,Direct
3523430,125,0,35,100,65,35,35,Direct
3523447,100,0,20,40,20,20,20,Direct
3523630,50,0,25,85,60,25,25,Direct
3523648,350,150,35,190,155,35,35,Direct
3523898,100,0,50,250,200,50,50,Direct
3523916,250,45,60,175,115,60,60,Direct
3511365,225,15,35,290,255,35,35,Direct
3510880,100,0,50,230,180,50,50,Direct
3524234,100,0,35,145,110,35,35,Direct
3524316,300,80,35,150,115,35,35,Direct
3524469,175,15,50,375,325,50,50,Direct
3530558,125,0,50,275,225,50,50,Direct
3530660,125,0,20,90,70,20,20,Direct
3530945,100,0,50,240,190,50,50,Direct
3530594,375,120,35,190,155,35,35,Direct
3531209,500,195,50,275,225,50,50,Direct
3531260,75,0,50,275,225,50,50,Direct
3531379,200,15,50,250,200,50,50,Direct
3531494,100,0,35,165,130,35,35,Direct
3531630,100,0,35,160,125,35,35,Direct
3531894,300,90,35,185,150,35,35,Direct
3528052,175,5,35,250,215,35,35,Direct
3531994,175,25,35,125,90,35,35,Direct
3532245,325,90,50,220,170,50,50,Direct
3532345,50,0,50,230,180,50,50,Direct
3532432,175,15,20,140,120,20,20,Direct
3532430,300,85,50,335,285,50,50,Direct
3532496,250,45,35,175,140,35,35,Direct
3532881,150,0,35,175,140,35,35,Direct
3533066,125,0,35,175,140,35,35,Direct
3533117,250,60,50,250,200,50,50,Direct
3533166,225,35,35,225,190,35,35,Direct
3533251,300,75,50,225,175,50,50,Direct
3533368,250,50,50,270,220,50,50,Direct
3533532,225,45,21,81,60,21,21,Direct
3533717,225,40,35,250,215,35,35,Direct
3534068,125,0,35,155,120,35,35,Direct
3534438,200,25,40,275,235,40,40,Direct
3534304,250,45,50,265,215,50,50,Direct
3534404,200,10,50,360,310,50,50,Direct
3534602,300,85,50,270,220,50,50,Direct
3534989,275,75,50,140,90,50,50,Direct
3535053,75,0,20,140,120,20,20,Direct
3535140,200,30,35,165,130,35,35,Direct
3535189,150,0,35,270,235,35,35,Direct
3535304,175,0,50,210,160,50,50,Direct
3532481,325,90,20,180,160,20,20,Direct
3535838,100,0,20,140,120,20,20,Direct
3536240,350,115,40,275,235,40,40,Direct
3536274,200,30,50,235,185,50,50,Direct
3536359,125,0,35,185,150,35,35,Direct
3536423,375,125,40,250,210,40,40,Direct
3536510,100,0,60,150,90,60,60,Direct
3536559,200,5,20,180,160,20,20,Direct
3536625,350,105,40,325,285,40,40,Direct
3536710,50,0,50,325,275,50,50,Direct
3536725,375,140,75,375,300,75,75,Direct
3536574,225,45,75,330,255,75,75,Direct
3536759,200,20,20,130,110,20,20,Direct
3536774,50,0,50,275,225,50,50,Direct
3536961,200,30,50,200,150,50,50,Direct
3537295,200,15,35,105,70,35,35,Direct
3537376,175,15,35,185,150,35,35,Direct
3537495,200,25,50,355,305,50,50,Direct
3537661,175,20,20,190,170,20,20,Direct
3537761,100,0,35,165,130,35,35,Direct
3538197,225,35,35,115,80,35,35,Direct
3536474,100,0,35,260,225,35,35,Direct
3538497,200,15,35,190,155,35,35,Direct
3532666,200,25,35,195,160,35,35,Direct
3539182,100,0,60,135,75,60,60,Direct
3539331,225,35,75,355,280,75,75,Direct
3539348,375,135,50,370,320,50,50,Direct
3522307,125,0,50,230,180,50,50,Direct
3522716,200,20,35,180,145,35,35,Direct
3522809,300,140,75,340,265,75,75,Direct
3522877,175,15,50,250,200,50,50,Direct
3522507,75,0,35,155,120,35,35,Direct
3522984,325,70,35,275,240,35,35,Direct
3523209,75,0,35,170,135,35,35,Direct
3523643,125,0,35,285,250,35,35,Direct
3498214,125,0,35,155,120,35,35,Direct
3524111,75,0,20,95,75,20,20,Direct
3524188,100,0,50,220,170,50,50,Direct
3524277,75,0,35,170,135,35,35,Direct
3524311,175,10,35,140,105,35,35,Direct
3524447,100,0,50,205,155,50,50,Direct
3524456,300,70,40,275,235,40,40,Direct
3524481,275,70,35,195,160,35,35,Direct
3524724,100,0,35,170,135,35,35,Direct
3524779,275,65,35,190,155,35,35,Direct
3524788,200,30,50,275,225,50,50,Direct
3524958,100,0,20,190,170,20,20,Direct
3524979,200,30,50,200,150,50,50,Direct
3525115,100,0,20,120,100,20,20,Direct
3525213,75,0,35,115,80,35,35,Direct
3525447,175,0,35,225,190,35,35,Direct
3525524,225,45,50,250,200,50,50,Direct
3525549,325,95,35,150,115,35,35,Direct
3525583,100,0,50,230,180,50,50,Direct
3525715,75,0,50,250,200,50,50,Direct
3526094,200,25,40,235,195,40,40,Direct
3518699,150,0,35,180,145,35,35,Direct
3526626,175,0,35,245,210,35,35,Direct
3526762,175,10,20,75,55,20,20,Direct
3526962,375,150,35,240,205,35,35,Direct
3527021,75,0,50,220,170,50,50,Direct
3527255,200,25,35,140,105,35,35,Direct
3527421,275,80,35,150,115,35,35,Direct
3528323,200,40,35,160,125,35,35,Direct
3528825,275,85,35,135,100,35,35,Direct
3529034,150,0,35,155,120,35,35,Direct
3529200,150,0,35,180,145,35,35,Direct
3522014,300,85,20,135,115,20,20,Direct
3529268,100,0,35,140,105,35,35,Direct
3529366,50,0,35,185,150,35,35,Direct
3529395,175,15,50,210,160,50,50,Direct
3529434,100,0,50,230,180,50,50,Direct
3513292,225,45,20,160,140,20,20,Direct
3529468,300,105,35,185,150,35,35,Direct
3529493,200,15,35,125,90,35,35,Direct
3529668,75,0,60,190,130,60,60,Direct
3530336,200,30,35,140,105,35,35,Direct
3530361,125,0,35,150,115,35,35,Direct
3530472,250,65,50,300,250,50,50,Direct
3530804,175,0,50,220,170,50,50,Direct
3530974,275,55,35,195,160,35,35,Direct
3526140,75,0,35,150,115,35,35,Direct
3526139,175,15,35,100,65,35,35,Direct
3526189,200,25,20,75,55,20,20,Direct
3525939,250,65,35,190,155,35,35,Direct
3526625,75,0,20,140,120,20,20,Direct
3526875,200,25,35,185,150,35,35,Direct
3526976,275,60,60,180,120,60,60,Direct
3527039,125,0,50,200,150,50,50,Direct
3527276,175,10,24,89,65,24,24,Direct
3527826,225,45,35,125,90,35,35,Direct
3511163,175,0,35,175,140,35,35,Direct
3499617,325,85,35,150,115,35,35,Direct
3528226,75,0,35,150,115,35,35,Direct
3528276,300,90,20,195,175,20,20,Direct
3528312,200,15,35,100,65,35,35,Direct
3528512,175,10,25,55,30,25,25,Direct
3528661,325,95,50,220,170,50,50,Direct
3528662,350,110,35,265,230,35,35,Direct
3528797,175,0,50,220,170,50,50,Direct
3529198,125,0,35,125,90,35,35,Direct
3529247,125,0,35,115,80,35,35,Direct
3529597,225,30,15,95,80,15,15,Direct
3529647,75,0,20,95,75,20,20,Direct
3529733,175,10,35,160,125,35,35,Direct
3529848,200,30,20,140,120,20,20,Direct
3529984,350,105,75,300,225,75,75,Direct
3530248,200,30,35,125,90,35,35,Direct
3530198,325,90,50,275,225,50,50,Direct
3530934,225,35,50,220,170,50,50,Direct
3531070,175,10,35,100,65,35,35,Direct
3528012,125,0,20,160,140,20,20,Direct
3531384,75,0,35,110,75,35,35,Direct
3531755,350,120,60,185,125,60,60,Direct
3531869,150,0,0,5,5,0,0,Direct
3523432,350,105,50,275,225,50,50,Direct
3506434,250,65,50,345,295,50,50,Direct
3532056,175,15,35,100,65,35,35,Direct
3532306,150,5,35,225,190,35,35,Direct
3532406,125,0,50,225,175,50,50,Direct
3532556,225,45,60,195,135,60,60,Direct
3532941,200,10,35,125,90,35,35,Direct
3532856,175,20,20,135,115,20,20,Direct
3533040,175,15,50,200,150,50,50,Direct
3533142,225,35,35,150,115,35,35,Direct
3533192,200,40,35,175,140,35,35,Direct
3533241,350,115,75,300,225,75,75,Direct
3533592,75,0,20,160,140,20,20,Direct
3533491,125,0,20,170,150,20,20,Direct
3534178,75,0,35,140,105,35,35,Direct
3534092,325,90,35,180,145,35,35,Direct
3534478,100,0,35,155,120,35,35,Direct
3533492,275,60,35,140,105,35,35,Direct
3534627,250,45,85,230,145,85,85,Direct
3534813,75,0,25,75,50,25,25,Direct
3535078,250,40,20,140,120,20,20,Direct
3519201,50,0,35,160,125,35,35,Direct
3535563,150,5,50,200,150,50,50,Direct
3525545,25,0,19,24,5,19,19,Direct
3525630,75,0,20,110,90,20,20,Direct
3525728,375,120,50,275,225,50,50,Direct
3526047,200,20,35,150,115,35,35,Direct
3526128,225,30,50,235,185,50,50,Direct
3526196,225,45,35,190,155,35,35,Direct
3526515,175,0,35,155,120,35,35,Direct
3525128,50,0,35,225,190,35,35,Direct
3526664,300,70,20,140,120,20,20,Direct
3526881,175,0,35,160,125,35,35,Direct
3526949,325,135,75,350,275,75,75,Direct
3527366,225,45,35,290,255,35,35,Direct
3498120,125,0,35,150,115,35,35,Direct
3528421,175,5,35,150,115,35,35,Direct
3528438,125,0,35,250,215,35,35,Direct
3528455,100,0,35,170,135,35,35,Direct
3528604,175,15,35,250,215,35,35,Direct
3528621,175,5,35,225,190,35,35,Direct
3516870,200,15,35,275,240,35,35,Direct
3528970,175,20,50,220,170,50,50,Direct
3529255,150,0,35,150,115,35,35,Direct
3529523,325,95,35,260,225,35,35,Direct
3529306,250,65,50,225,175,50,50,Direct
3529506,50,0,35,160,125,35,35,Direct
3529706,150,5,35,175,140,35,35,Direct
3529723,25,0,35,125,90,35,35,Direct
3529855,275,65,50,220,170,50,50,Direct
3530042,200,10,35,120,85,35,35,Direct
3530059,375,135,35,260,225,35,35,Direct
3530293,200,5,35,125,90,35,35,Direct
3530374,300,85,20,190,170,20,20,Direct
3530510,75,0,20,95,75,20,20,Direct
3530608,175,5,60,150,90,60,60,Direct
3530910,150,0,50,205,155,50,50,Direct
3531161,225,25,35,160,125,35,35,Direct
3531246,275,70,35,150,115,35,35,Direct
3531276,275,55,60,130,70,60,60,Direct
3531429,350,100,50,230,180,50,50,Direct
3531463,75,0,35,135,100,35,35,Direct
3508233,225,35,35,180,145,35,35,Direct
3532046,275,60,50,260,210,50,50,Direct
3532297,175,0,35,185,150,35,35,Direct
3514632,200,30,20,160,140,20,20,Direct
3532348,225,35,35,145,110,35,35,Direct
3532446,275,65,20,160,140,20,20,Direct
3532565,75,0,40,200,160,40,40,Direct
3532765,75,0,35,135,100,35,35,Direct
3533033,225,45,50,395,345,50,50,Direct
3533318,225,80,50,225,175,50,50,Direct
3533348,175,5,20,140,120,20,20,Direct
3533399,125,0,50,230,180,50,50,Direct
3533565,450,145,35,190,155,35,35,Direct
3533582,175,5,33,178,145,33,33,Direct
3533650,200,25,75,300,225,75,75,Direct
3533735,125,0,35,150,115,35,35,Direct
3453630,425,145,75,370,295,75,75,Direct
3524255,125,0,35,125,90,35,35,Direct
3524405,125,0,50,270,220,50,50,Direct
3524455,75,0,35,140,105,35,35,Direct
3524523,100,0,35,220,185,35,35,Direct
3523383,275,60,50,235,185,50,50,Direct
3524923,50,0,50,230,180,50,50,Direct
3525055,175,5,50,290,240,50,50,Direct
3516556,225,15,50,200,150,50,50,Direct
3525116,100,0,35,110,75,35,35,Direct
3525191,225,20,20,135,115,20,20,Direct
3525323,125,0,35,135,100,35,35,Direct
3525316,175,15,35,100,65,35,35,Direct
3525409,175,15,35,180,145,35,35,Direct
3525516,275,70,35,145,110,35,35,Direct
3525459,175,0,25,70,45,25,25,Direct
3520593,50,0,50,260,210,50,50,Direct
3525991,225,30,35,260,225,35,35,Direct
3526545,50,0,25,55,30,25,25,Direct
3526570,300,85,75,300,225,75,75,Direct
3526584,200,25,20,80,60,20,20,Direct
3526702,125,0,25,70,45,25,25,Direct
3526744,75,0,50,235,185,50,50,Direct
3526838,175,20,35,100,65,35,35,Direct
3527188,75,0,20,85,65,20,20,Direct
3527213,75,0,35,155,120,35,35,Direct
3527813,75,0,35,150,115,35,35,Direct
3527881,100,0,25,80,55,25,25,Direct
3527931,50,0,25,50,25,25,25,Direct
3527988,50,0,20,185,165,20,20,Direct
3528013,100,0,20,170,150,20,20,Direct
3516381,325,90,35,155,120,35,35,Direct
3528306,350,130,35,185,150,35,35,Direct
3528263,300,100,50,265,215,50,50,Direct
3528281,100,0,35,225,190,35,35,Direct
3528481,125,0,35,175,140,35,35,Direct
3528792,200,25,35,105,70,35,35,Direct
3529135,225,30,35,140,105,35,35,Direct
3529149,200,15,35,170,135,35,35,Direct
3529796,250,50,35,175,140,35,35,Direct
3529953,200,30,50,320,270,50,50,Direct
3529978,175,5,50,200,150,50,50,Direct
3530003,150,0,35,190,155,35,35,Direct
3530203,100,0,35,160,125,35,35,Direct
3530221,275,75,35,185,150,35,35,Direct
3530271,275,85,50,330,280,50,50,Direct
3530378,125,0,20,85,65,20,20,Direct
3530796,200,30,75,320,245,75,75,Direct
3434000,175,15,50,275,225,50,50,Direct
3530939,250,50,40,340,300,40,40,Direct
3530982,300,70,20,140,120,20,20,Direct
3531139,175,10,40,240,200,40,40,Direct
3531157,25,0,35,105,70,35,35,Direct
3531339,75,0,35,150,115,35,35,Direct
3531557,175,0,35,115,80,35,35,Direct
3532075,175,10,35,260,225,35,35,Direct
3532182,250,45,75,380,305,75,75,Direct
3532318,175,10,35,265,230,35,35,Direct
3532493,350,185,75,380,305,75,75,Direct
3532625,175,5,35,175,140,35,35,Direct
3533254,300,75,20,170,150,20,20,Direct
3519030,300,90,20,130,110,20,20,Direct
3519459,125,0,35,150,115,35,35,Direct
3519766,200,20,35,290,255,35,35,Direct
3518816,175,10,35,150,115,35,35,Direct
3514529,100,0,35,125,90,35,35,Direct
3520216,50,0,35,145,110,35,35,Direct
3520452,25,0,35,250,215,35,35,Direct
3520545,100,0,50,200,150,50,50,Direct
3520738,125,0,35,170,135,35,35,Direct
3520952,125,0,20,160,140,20,20,Direct
3521045,100,0,25,85,60,25,25,Direct
3521095,150,0,35,165,130,35,35,Direct
3521188,175,10,35,160,125,35,35,Direct
3521231,200,30,50,200,150,50,50,Direct
3521331,50,0,35,160,125,35,35,Direct
3521681,175,15,60,155,95,60,60,Direct
3521788,200,15,50,275,225,50,50,Direct
3522038,200,20,33,188,155,33,33,Direct
3522531,275,75,35,190,155,35,35,Direct
3522681,125,0,35,165,130,35,35,Direct
3523067,250,65,75,340,265,75,75,Direct
3523153,50,0,27,97,70,27,27,Direct
3523210,175,15,75,375,300,75,75,Direct
3523360,125,0,5,10,5,5,5,Direct
3523367,75,0,25,80,55,25,25,Direct
3523560,150,5,35,140,105,35,35,Direct
3523796,175,5,50,220,170,50,50,Direct
3523810,175,5,20,170,150,20,20,Direct
3513450,75,0,35,130,95,35,35,Direct
3524096,75,0,35,180,145,35,35,Direct
3523953,50,0,50,235,185,50,50,Direct
3524196,200,10,20,140,120,20,20,Direct
3524246,300,110,50,275,225,50,50,Direct
3524296,150,5,35,150,115,35,35,Direct
3515908,125,0,35,155,120,35,35,Direct
3524389,100,0,50,210,160,50,50,Direct
3524439,250,45,20,140,120,20,20,Direct
3524596,225,45,20,135,115,20,20,Direct
3524603,75,0,35,135,100,35,35,Direct
3524732,175,10,20,90,70,20,20,Direct
3524496,75,0,35,110,75,35,35,Direct
3525096,200,30,50,205,155,50,50,Direct
3525239,175,15,35,175,140,35,35,Direct
3525932,275,75,75,345,270,75,75,Direct
3525968,125,0,50,230,180,50,50,Direct
3526032,250,60,50,210,160,50,50,Direct
3526261,75,0,40,230,190,40,40,Direct
3526468,100,0,25,50,25,25,25,Direct
3526518,125,0,35,260,225,35,35,Direct
3526511,125,0,35,170,135,35,35,Direct
3526554,100,0,35,190,155,35,35,Direct
3526704,300,95,50,375,325,50,50,Direct
3539933,175,5,35,120,85,35,35,Direct
3540120,175,10,20,160,140,20,20,Direct
3539382,75,0,35,175,140,35,35,Direct
3527401,275,50,35,100,65,35,35,Direct
3540605,200,30,35,270,235,35,35,Direct
3540618,125,0,40,375,335,40,40,Direct
3540620,275,85,50,350,300,50,50,Direct
3540854,100,0,50,235,185,50,50,Direct
3540903,300,80,50,250,200,50,50,Direct
3541069,200,35,35,280,245,35,35,Direct
3541156,1775,1305,650,2475,1825,650,650,Direct
3541254,200,20,35,140,105,35,35,Direct
3541354,125,0,35,160,125,35,35,Direct
3541641,100,0,100,230,130,100,100,Direct
3541905,250,65,20,125,105,20,20,Direct
3542075,175,0,35,115,80,35,35,Direct
3542090,250,50,50,210,160,50,50,Direct
3542239,75,0,35,155,120,35,35,Direct
3542475,125,0,35,165,130,35,35,Direct
3542541,150,0,25,95,70,25,25,Direct
3542792,175,5,60,120,60,60,60,Direct
3542826,100,0,35,150,115,35,35,Direct
3543041,150,0,50,300,250,50,50,Direct
3543075,175,10,35,125,90,35,35,Direct
3543626,175,0,35,165,130,35,35,Direct
3465112,100,0,60,195,135,60,60,Direct
3544347,300,100,35,240,205,35,35,Direct
3544647,325,115,35,185,150,35,35,Direct
3544747,375,150,50,220,170,50,50,Direct
3545264,125,0,20,95,75,20,20,Direct
3545500,175,5,20,125,105,20,20,Direct
3545919,200,35,50,230,180,50,50,Direct
3545985,175,20,50,270,220,50,50,Direct
3546085,225,35,20,75,55,20,20,Direct
3546200,75,0,35,170,135,35,35,Direct
3437738,200,10,50,230,180,50,50,Direct
3546470,225,45,35,150,115,35,35,Direct
3534638,300,115,35,185,150,35,35,Direct
3546785,375,135,35,200,165,35,35,Direct
3546836,50,0,35,255,220,35,35,Direct
3547072,50,0,35,230,195,35,35,Direct
3547106,100,0,35,240,205,35,35,Direct
3547121,175,5,35,180,145,35,35,Direct
3547170,125,0,25,80,55,25,25,Direct
3539684,150,5,35,155,120,35,35,Direct
3547272,100,0,50,260,210,50,50,Direct
3547455,350,135,50,250,200,50,50,Direct
3547506,175,10,60,105,45,60,60,Direct
3547606,175,15,50,200,150,50,50,Direct
3547621,125,0,20,160,140,20,20,Direct
3547772,200,30,50,225,175,50,50,Direct
3547955,250,65,50,200,150,50,50,Direct
3547957,100,0,50,220,170,50,50,Direct
3548055,100,0,35,155,120,35,35,Direct
3548557,175,15,25,80,55,25,25,Direct
3533953,100,0,20,55,35,20,20,Direct
3539384,175,15,35,190,155,35,35,Direct
3533032,325,105,35,190,155,35,35,Direct
3549144,200,25,50,270,220,50,50,Direct
3549342,200,15,50,255,205,50,50,Direct
3549427,250,60,35,175,140,35,35,Direct
3549878,100,0,60,145,85,60,60,Direct
3549978,375,105,40,235,195,40,40,Direct
3547739,100,0,50,250,200,50,50,Direct
3564804,175,0,50,230,180,50,50,Direct
3564851,75,0,20,140,120,20,20,Direct
3471331,225,25,35,135,100,35,35,Direct
3565489,125,0,35,255,220,35,35,Direct
3565523,275,60,20,180,160,20,20,Direct
3566055,300,70,35,170,135,35,35,Direct
3566340,250,40,35,145,110,35,35,Direct
3566374,25,0,35,125,90,35,35,Direct
3566557,50,0,35,155,120,35,35,Direct
3566791,175,10,35,185,150,35,35,Direct
3566693,250,65,50,385,335,50,50,Direct
3493693,125,0,35,285,250,35,35,Direct
3566774,250,60,50,235,185,50,50,Direct
3566991,175,10,35,280,245,35,35,Direct
3567344,275,75,35,150,115,35,35,Direct
3567995,125,0,35,100,65,35,35,Direct
3568314,250,50,35,255,220,35,35,Direct
3568446,175,10,35,150,115,35,35,Direct
3568714,200,30,35,205,170,35,35,Direct
3564634,275,65,35,190,155,35,35,Direct
3562345,575,250,125,550,425,125,125,Direct
3569216,250,60,35,150,115,35,35,Direct
3569982,250,50,50,290,240,50,50,Direct
3570552,150,5,35,185,150,35,35,Direct
3571071,200,35,20,155,135,20,20,Direct
3571505,50,0,35,185,150,35,35,Direct
3572539,75,0,35,125,90,35,35,Direct
3572909,125,0,35,125,90,35,35,Direct
3573275,175,0,35,185,150,35,35,Direct
3573458,200,20,50,275,225,50,50,Direct
3574394,225,45,50,275,225,50,50,Direct
3574628,225,60,20,110,90,20,20,Direct
3540395,175,10,35,180,145,35,35,Direct
3540528,225,40,20,185,165,20,20,Direct
3540613,125,0,35,185,150,35,35,Direct
3540677,175,10,50,270,220,50,50,Direct
3540660,175,0,50,50,25,25,25,Direct
3540727,175,0,20,170,150,20,20,Direct
3540846,275,55,35,140,105,35,35,Direct
3540877,200,30,35,145,110,35,35,Direct
3541046,200,10,50,275,225,50,50,Direct
3540928,400,140,35,240,205,35,35,Direct
3541131,75,0,50,220,170,50,50,Direct
3541196,225,40,60,150,90,60,60,Direct
3541264,75,0,50,220,170,50,50,Direct
3541382,125,0,20,160,140,20,20,Direct
3541514,75,0,35,185,150,35,35,Direct
3541596,125,0,35,215,180,35,35,Direct
3541864,200,25,35,175,140,35,35,Direct
3542017,450,170,75,305,230,75,75,Direct
3542250,100,0,20,150,130,20,20,Direct
3542267,200,15,35,150,115,35,35,Direct
3542349,125,0,35,150,115,35,35,Direct
3542382,125,0,15,95,80,15,15,Direct
3542532,275,95,50,275,225,50,50,Direct
3542685,200,25,20,75,55,20,20,Direct
3543067,225,45,35,150,115,35,35,Direct
3543267,200,25,60,125,65,60,60,Direct
3543386,325,105,35,155,120,35,35,Direct
3543417,75,0,25,85,60,25,25,Direct
3543604,200,15,35,165,130,35,35,Direct
3543603,100,0,35,185,150,35,35,Direct
3543621,300,100,55,455,400,55,55,Direct
3544186,300,85,75,335,260,75,75,Direct
3544254,100,0,35,125,90,35,35,Direct
3544271,175,0,40,245,205,40,40,Direct
3544557,175,5,50,265,215,50,50,Direct
3544604,225,35,35,125,90,35,35,Direct
3534861,275,85,35,185,150,35,35,Direct
3545139,75,0,35,150,115,35,35,Direct
3545157,375,140,40,210,170,40,40,Direct
3545994,225,45,50,275,225,50,50,Direct
3546058,250,40,60,180,120,60,60,Direct
3546143,325,125,35,190,155,35,35,Direct
3546262,100,0,60,175,115,60,60,Direct
3546126,275,75,110,425,315,110,110,Direct
3546326,125,0,35,150,115,35,35,Direct
3546479,200,25,35,190,155,35,35,Direct
3546761,350,130,35,225,190,35,35,Direct
3546679,100,0,35,170,135,35,35,Direct
3547629,175,10,35,125,90,35,35,Direct
3547615,200,30,35,260,225,35,35,Direct
3547765,200,30,35,160,125,35,35,Direct
3547815,25,0,25,55,30,25,25,Direct
3547833,200,30,20,140,120,20,20,Direct
3547897,200,25,50,220,170,50,50,Direct
3548083,200,40,20,75,55,20,20,Direct
3548134,50,0,5,10,5,5,5,Direct
3548348,100,0,35,175,140,35,35,Direct
3548365,250,65,35,135,100,35,35,Direct
3548615,225,45,50,230,180,50,50,Direct
3548683,200,25,50,280,230,50,50,Direct
3548833,275,65,50,225,175,50,50,Direct
3548952,225,40,35,240,205,35,35,Direct
3549169,250,55,50,345,295,50,50,Direct
3549752,100,0,40,200,160,40,40,Direct
3533429,50,0,35,170,135,35,35,Direct
3533697,50,0,35,185,150,35,35,Direct
3533872,75,0,35,195,160,35,35,Direct
3534079,150,0,50,250,200,50,50,Direct
3534258,75,0,20,130,110,20,20,Direct
3534297,200,20,20,85,65,20,20,Direct
3534483,200,25,50,275,225,50,50,Direct
3534522,175,0,50,300,250,50,50,Direct
3534740,200,25,35,125,90,35,35,Direct
3534833,50,0,35,180,145,35,35,Direct
3534951,175,15,35,185,150,35,35,Direct
3535433,125,0,50,210,160,50,50,Direct
3533386,150,0,25,85,60,25,25,Direct
3535887,125,0,50,280,230,50,50,Direct
3535951,200,15,35,170,135,35,35,Direct
3536012,150,0,35,170,135,35,35,Direct
3536062,175,10,35,180,145,35,35,Direct
3536130,200,20,50,285,235,50,50,Direct
3536144,75,0,50,200,150,50,50,Direct
3536262,250,50,50,250,200,50,50,Direct
3536219,225,75,50,215,165,50,50,Direct
3536344,175,20,35,200,165,35,35,Direct
3536412,125,0,35,185,150,35,35,Direct
3536437,125,0,35,245,210,35,35,Direct
3536462,175,10,35,190,155,35,35,Direct
3536573,175,20,25,70,45,25,25,Direct
3536637,175,5,50,200,150,50,50,Direct
3536730,150,0,50,260,210,50,50,Direct
3537041,100,0,50,275,225,50,50,Direct
3537023,100,0,50,325,275,50,50,Direct
3537173,325,160,35,250,215,35,35,Direct
3537441,125,0,35,160,125,35,35,Direct
3537866,175,5,35,250,215,35,35,Direct
3537998,300,75,50,200,150,50,50,Direct
3538023,300,95,35,260,225,35,35,Direct
3538734,200,10,35,120,85,35,35,Direct
3538845,100,0,35,150,115,35,35,Direct
3538963,175,5,20,95,75,20,20,Direct
3539088,200,20,35,155,120,35,35,Direct
3539138,100,0,50,275,225,50,50,Direct
3539202,75,0,20,140,120,20,20,Direct
3539338,200,20,20,160,140,20,20,Direct
3539563,275,70,50,270,220,50,50,Direct
3539581,175,5,20,65,45,20,20,Direct
3539695,125,0,35,160,125,35,35,Direct
3540231,200,40,50,250,200,50,50,Direct
3528399,100,0,35,125,90,35,35,Direct
3531196,300,110,35,150,115,35,35,Direct
3540406,175,5,50,275,225,50,50,Direct
3540567,250,60,50,260,210,50,50,Direct
3540692,125,0,35,150,115,35,35,Direct
3540849,200,30,35,245,210,35,35,Direct
3541117,350,100,50,230,180,50,50,Direct
3541342,200,25,25,95,70,25,25,Direct
3542121,75,0,35,135,100,35,35,Direct
3542303,175,15,50,205,155,50,50,Direct
3542364,175,0,50,220,170,50,50,Direct
3542478,175,5,50,275,225,50,50,Direct
3542521,175,10,35,195,160,35,35,Direct
3542703,100,0,35,140,105,35,35,Direct
3543296,425,195,75,275,200,75,75,Direct
3543350,250,40,50,225,175,50,50,Direct
3543389,175,15,35,180,145,35,35,Direct
3527429,125,0,25,55,30,25,25,Direct
3482666,250,60,35,190,155,35,35,Direct
3527779,175,0,20,140,120,20,20,Direct
3522199,25,0,35,180,145,35,35,Direct
3513389,500,195,75,345,270,75,75,Direct
3528158,300,90,35,190,155,35,35,Direct
3528258,100,0,20,75,55,20,20,Direct
3528851,200,30,35,150,115,35,35,Direct
3528858,175,15,20,170,150,20,20,Direct
3529051,275,85,50,290,240,50,50,Direct
3529015,150,0,35,190,155,35,35,Direct
3529687,200,15,50,275,225,50,50,Direct
3529980,200,20,20,95,75,20,20,Direct
3530380,100,0,20,145,125,20,20,Direct
3530480,175,10,35,265,230,35,35,Direct
3530637,75,0,20,70,50,20,20,Direct
3530623,175,15,20,135,115,20,20,Direct
3531073,250,65,35,170,135,35,35,Direct
3531180,150,0,35,195,160,35,35,Direct
3531273,125,0,35,185,150,35,35,Direct
3531873,200,30,20,180,160,20,20,Direct
3531080,175,10,35,190,155,35,35,Direct
3517469,50,0,35,180,145,35,35,Direct
3532152,125,0,35,135,100,35,35,Direct
3532409,175,15,20,150,130,20,20,Direct
3532445,75,0,35,155,120,35,35,Direct
3532509,325,75,35,150,115,35,35,Direct
3532595,225,45,60,195,135,60,60,Direct
3436338,250,75,35,180,145,35,35,Direct
3528865,175,10,35,200,165,35,35,Direct
3532709,175,5,35,200,165,35,35,Direct
3532752,125,0,50,250,200,50,50,Direct
3532845,75,0,50,250,200,50,50,Direct
3532902,200,30,35,185,150,35,35,Direct
3533095,200,25,35,295,260,35,35,Direct
3533188,50,0,20,80,60,20,20,Direct
3533202,300,100,50,210,160,50,50,Direct
3533195,475,165,35,290,255,35,35,Direct
3533345,250,60,50,250,200,50,50,Direct
3533731,75,0,20,75,55,20,20,Direct
3533745,100,0,20,40,20,20,20,Direct
3534124,150,0,20,165,145,20,20,Direct
3534181,100,0,20,35,15,20,20,Direct
3534324,275,75,50,280,230,50,50,Direct
3534374,100,0,35,170,135,35,35,Direct
3534674,250,50,35,185,150,35,35,Direct
3534431,75,0,19,94,75,19,19,Direct
3534960,200,20,35,170,135,35,35,Direct
3532009,75,0,35,100,65,35,35,Direct
3535024,125,0,20,140,120,20,20,Direct
3535260,450,145,35,225,190,35,35,Direct
3535317,125,0,50,250,200,50,50,Direct
3535353,50,0,35,100,65,35,35,Direct
3535517,125,0,35,175,140,35,35,Direct
3522885,300,75,35,160,125,35,35,Direct
3506523,300,70,50,200,150,50,50,Direct
3535710,200,5,35,150,115,35,35,Direct
3535760,75,0,35,155,120,35,35,Direct
3535796,125,0,60,150,90,60,60,Direct
3536253,300,75,35,175,140,35,35,Direct
3550080,100,0,25,50,25,25,25,Direct
3550714,200,15,50,280,230,50,50,Direct
3550865,250,60,60,120,60,60,60,Direct
3550950,150,5,45,150,105,45,45,Direct
3551016,75,0,20,85,65,20,20,Direct
3551150,125,0,35,170,135,35,35,Direct
3551314,100,0,50,325,275,50,50,Direct
3551399,225,30,35,185,150,35,35,Direct
3551535,375,120,50,275,225,50,50,Direct
3551550,175,10,50,200,150,50,50,Direct
3551952,200,20,35,150,115,35,35,Direct
3552437,150,0,35,160,125,35,35,Direct
3552552,125,0,35,240,205,35,35,Direct
3552571,275,75,75,350,275,75,75,Direct
3552952,100,0,35,140,105,35,35,Direct
3495664,175,10,35,170,135,35,35,Direct
3553288,175,10,35,210,175,35,35,Direct
3553337,100,0,50,255,205,50,50,Direct
3553788,275,70,50,230,180,50,50,Direct
3553958,275,65,35,145,110,35,35,Direct
3554207,275,60,50,275,225,50,50,Direct
3554507,200,25,20,180,160,20,20,Direct
3554558,150,0,35,225,190,35,35,Direct
3554624,250,70,50,205,155,50,50,Direct
3554643,100,0,35,175,140,35,35,Direct
3554809,175,10,35,105,70,35,35,Direct
3555043,75,0,35,140,105,35,35,Direct
3555243,100,0,35,160,125,35,35,Direct
3555309,75,0,35,160,125,35,35,Direct
3555409,175,10,35,125,90,35,35,Direct
3555494,150,0,35,190,155,35,35,Direct
3555560,100,0,25,60,35,25,25,Direct
3555894,25,0,60,145,85,60,60,Direct
3555945,225,15,50,240,190,50,50,Direct
3556296,50,0,35,160,125,35,35,Direct
3474972,75,0,35,155,120,35,35,Direct
3556481,325,110,50,210,160,50,50,Direct
3556645,175,10,50,355,305,50,50,Direct
3541554,100,0,35,285,250,35,35,Direct
3556730,25,0,35,125,90,35,35,Direct
3516269,150,0,35,160,125,35,35,Direct
3557066,275,80,75,380,305,75,75,Direct
3557115,200,30,50,275,225,50,50,Direct
3548908,175,10,35,295,260,35,35,Direct
3557432,200,15,50,210,160,50,50,Direct
3557481,200,40,50,325,275,50,50,Direct
3557766,200,25,35,100,65,35,35,Direct
3557866,175,15,35,140,105,35,35,Direct
3558317,175,10,20,140,120,20,20,Direct
3558268,100,0,20,140,120,20,20,Direct
3558653,200,30,35,150,115,35,35,Direct
3558651,200,20,35,165,130,35,35,Direct
3558768,75,0,25,70,45,25,25,Direct
3559189,150,5,35,180,145,35,35,Direct
3559423,175,0,50,205,155,50,50,Direct
3560389,175,5,50,325,275,50,50,Direct
3560474,125,0,25,90,65,25,25,Direct
3560574,150,0,50,200,150,50,50,Direct
3560740,50,0,35,100,65,35,35,Direct
3560759,75,0,50,210,160,50,50,Direct
3560974,200,30,50,325,275,50,50,Direct
3561010,125,0,35,155,120,35,35,Direct
3561176,175,5,35,170,135,35,35,Direct
3561125,275,70,50,380,330,50,50,Direct
3561659,175,10,75,330,255,75,75,Direct
3561276,175,5,20,140,120,20,20,Direct
3562295,175,5,20,140,120,20,20,Direct
3562395,225,50,35,105,70,35,35,Direct
3573424,250,60,20,180,160,20,20,Direct
3574883,175,10,40,240,200,40,40,Direct
3526854,125,0,35,160,125,35,35,Direct
3526968,200,25,50,240,190,50,50,Direct
3527111,200,10,50,275,225,50,50,Direct
3525582,100,0,35,155,120,35,35,Direct
3527647,25,0,35,180,145,35,35,Direct
3527747,325,160,110,420,310,110,110,Direct
3527797,225,45,50,270,220,50,50,Direct
3527947,475,165,45,375,330,45,45,Direct
3527397,200,35,50,275,225,50,50,Direct
3524453,200,25,35,165,130,35,35,Direct
3528333,200,30,50,250,200,50,50,Direct
3528340,375,135,100,255,155,100,100,Direct
3528490,175,15,20,155,135,20,20,Direct
3528676,175,20,23,73,50,23,23,Direct
3528983,250,55,20,160,140,20,20,Direct
3529219,300,70,40,375,335,40,40,Direct
3529519,225,40,35,190,155,35,35,Direct
3529626,125,0,20,75,55,20,20,Direct
3529926,175,10,35,150,115,35,35,Direct
3529969,100,0,20,105,85,20,20,Direct
3530019,275,75,20,160,140,20,20,Direct
3530069,175,5,35,250,215,35,35,Direct
3530262,150,0,35,150,115,35,35,Direct
3530355,175,0,50,220,170,50,50,Direct
3530812,100,0,50,220,170,50,50,Direct
3530991,225,45,20,95,75,20,20,Direct
3530955,375,165,50,240,190,50,50,Direct
3531055,175,15,75,335,260,75,75,Direct
3531241,200,20,35,185,150,35,35,Direct
3531448,125,0,35,100,65,35,35,Direct
3531648,300,95,75,345,270,75,75,Direct
3531205,175,10,50,200,150,50,50,Direct
3531798,275,75,50,250,200,50,50,Direct
3522081,225,25,35,180,145,35,35,Direct
3532091,375,125,50,245,195,50,50,Direct
3532177,275,60,35,185,150,35,35,Direct
3532234,300,100,50,275,225,50,50,Direct
3532520,200,20,50,280,230,50,50,Direct
3532677,150,0,20,150,130,20,20,Direct
3532884,175,5,35,150,115,35,35,Direct
3532927,225,30,25,90,65,25,25,Direct
3532977,275,60,20,75,55,20,20,Direct
3533020,200,30,35,125,90,35,35,Direct
3533063,350,105,20,195,175,20,20,Direct
3533113,150,0,35,175,140,35,35,Direct
3533356,150,0,26,81,55,26,26,Direct
3533320,200,30,50,205,155,50,50,Direct
3533520,100,0,50,210,160,50,50,Direct
3533513,350,105,35,190,155,35,35,Direct
3533620,50,0,35,180,145,35,35,Direct
3533656,250,65,35,160,125,35,35,Direct
3533863,200,25,35,155,120,35,35,Direct
3534492,100,0,35,145,110,35,35,Direct
3534642,200,25,20,140,120,20,20,Direct
3534856,350,125,20,180,160,20,20,Direct
3534892,275,75,55,400,345,55,55,Direct
3535042,750,370,400,1000,600,400,400,Direct
3535085,200,30,50,300,250,50,50,Direct
3535142,75,0,35,160,125,35,35,Direct
3535235,175,5,20,160,140,20,20,Direct
3535328,450,170,50,250,200,50,50,Direct
3535428,225,45,35,160,125,35,35,Direct
3501640,50,0,35,175,140,35,35,Direct
3501676,200,15,35,190,155,35,35,Direct
3501776,125,0,35,150,115,35,35,Direct
3502069,75,0,35,115,80,35,35,Direct
3488465,225,45,33,168,135,33,33,Direct
3491914,125,0,35,170,135,35,35,Direct
3503939,175,10,35,190,155,35,35,Direct
3503975,300,85,35,190,155,35,35,Direct
3504041,125,0,35,160,125,35,35,Direct
3504341,200,10,50,240,190,50,50,Direct
3504582,50,0,20,70,50,20,20,Direct
3504584,125,0,50,230,180,50,50,Direct
3504641,75,0,35,170,135,35,35,Direct
3504677,150,0,35,135,100,35,35,Direct
3504884,325,90,50,275,225,50,50,Direct
3505041,200,30,35,290,255,35,35,Direct
3505077,175,15,35,110,75,35,35,Direct
3505454,275,80,35,130,95,35,35,Direct
3505554,100,0,40,250,210,40,40,Direct
3505618,100,0,35,130,95,35,35,Direct
3502705,175,10,35,250,215,35,35,Direct
3422217,225,45,35,245,210,35,35,Direct
3506220,525,215,310,765,455,310,310,Direct
3506254,25,0,50,220,170,50,50,Direct
3506356,25,0,36,151,115,36,36,Direct
3506454,125,0,25,55,30,25,25,Direct
3506590,625,295,70,490,420,70,70,Direct
3506613,50,0,35,165,130,35,35,Direct
3506790,400,160,50,250,200,50,50,Direct
3507083,200,25,50,275,225,50,50,Direct
3507183,75,0,20,140,120,20,20,Direct
3507226,100,0,60,100,40,60,60,Direct
3475068,50,0,35,180,145,35,35,Direct
3507626,225,25,20,95,75,20,20,Direct
3507685,300,75,50,265,215,50,50,Direct
3503882,375,135,110,440,330,110,110,Direct
3507819,300,75,35,265,230,35,35,Direct
3507849,175,10,35,190,155,35,35,Direct
3508226,350,135,50,325,275,50,50,Direct
3508262,125,0,20,140,120,20,20,Direct
3415572,250,50,25,95,70,25,25,Direct
3508392,275,75,35,290,255,35,35,Direct
3505184,150,0,35,245,210,35,35,Direct
3508719,100,0,35,150,115,35,35,Direct
3508862,150,5,35,150,115,35,35,Direct
3508885,200,35,35,155,120,35,35,Direct
3509019,125,0,25,75,50,25,25,Direct
3509021,150,0,35,180,145,35,35,Direct
3509228,175,20,25,80,55,25,25,Direct
3509757,200,30,50,200,150,50,50,Direct
3510234,125,0,50,230,180,50,50,Direct
3510334,75,0,35,180,145,35,35,Direct
3510393,25,0,35,170,135,35,35,Direct
3510498,125,0,20,140,120,20,20,Direct
3506983,125,0,20,30,10,20,20,Direct
3510593,300,90,40,205,165,40,40,Direct
3535613,200,50,35,245,210,35,35,Direct
3535750,225,45,20,140,120,20,20,Direct
3535864,300,70,50,200,150,50,50,Direct
3536164,175,10,35,255,220,35,35,Direct
3536600,200,30,35,290,255,35,35,Direct
3536635,25,0,35,175,140,35,35,Direct
3536699,125,0,35,225,190,35,35,Direct
3536885,100,0,35,175,140,35,35,Direct
3536950,225,75,35,175,140,35,35,Direct
3537436,200,20,35,295,260,35,35,Direct
3537635,125,0,35,175,140,35,35,Direct
3537686,100,0,50,220,170,50,50,Direct
3537822,150,5,50,235,185,50,50,Direct
3531020,100,0,35,280,245,35,35,Direct
3538422,100,0,35,150,115,35,35,Direct
3538557,175,20,35,175,140,35,35,Direct
3538757,100,0,35,150,115,35,35,Direct
3538758,400,140,35,260,225,35,35,Direct
3538907,200,20,20,175,155,20,20,Direct
3539493,300,100,35,155,120,35,35,Direct
3539543,25,0,35,205,170,35,35,Direct
3539557,100,0,35,180,145,35,35,Direct
3539607,375,135,50,275,225,50,50,Direct
3537922,200,15,20,90,70,20,20,Direct
3533941,200,20,35,155,120,35,35,Direct
3540344,250,50,35,165,130,35,35,Direct
3537721,175,10,60,125,65,60,60,Direct
3540744,100,0,50,200,150,50,50,Direct
3540794,275,95,35,170,135,35,35,Direct
3540880,225,50,50,355,305,50,50,Direct
3540994,225,45,50,375,325,50,50,Direct
3541044,175,0,50,250,200,50,50,Direct
3541429,225,35,35,260,225,35,35,Direct
3541515,100,0,35,265,230,35,35,Direct
3541365,225,25,35,135,100,35,35,Direct
3541766,475,195,50,250,200,50,50,Direct
3522059,175,10,35,125,90,35,35,Direct
3542251,250,65,50,325,275,50,50,Direct
3542401,125,0,35,150,115,35,35,Direct
3542451,175,15,35,120,85,35,35,Direct
3542551,325,95,60,160,100,60,60,Direct
3542516,275,70,20,175,155,20,20,Direct
3542565,325,95,55,410,355,55,55,Direct
3542601,150,0,35,185,150,35,35,Direct
3542701,375,130,50,275,225,50,50,Direct
3542966,75,0,50,225,175,50,50,Direct
3543152,100,0,35,110,75,35,35,Direct
3543452,150,5,35,230,195,35,35,Direct
3543551,50,0,20,75,55,20,20,Direct
3543588,300,90,35,150,115,35,35,Direct
3543738,200,15,35,235,200,35,35,Direct
3544573,250,65,35,115,80,35,35,Direct
3544437,250,55,35,125,90,35,35,Direct
3524652,150,0,35,225,190,35,35,Direct
3524801,175,0,40,240,200,40,40,Direct
3525001,200,25,35,150,115,35,35,Direct
3525034,300,70,35,265,230,35,35,Direct
3525388,100,0,35,190,155,35,35,Direct
3525387,125,0,25,80,55,25,25,Direct
3525469,125,0,20,160,140,20,20,Direct
3525587,225,35,50,230,180,50,50,Direct
3525588,75,0,50,235,185,50,50,Direct
3524065,100,0,40,210,170,40,40,Direct
3525787,150,0,35,280,245,35,35,Direct
3525856,100,0,60,125,65,60,60,Direct
3525919,50,0,20,65,45,20,20,Direct
3526055,175,5,20,140,120,20,20,Direct
3526073,200,30,35,260,225,35,35,Direct
3526473,25,0,20,80,60,20,20,Direct
3526774,125,0,20,125,105,20,20,Direct
3526842,100,0,35,170,135,35,35,Direct
3526974,175,10,60,195,135,60,60,Direct
3527059,200,35,50,225,175,50,50,Direct
3527242,100,0,35,145,110,35,35,Direct
3527259,400,150,50,375,325,50,50,Direct
3503060,200,20,35,185,150,35,35,Direct
3527310,75,0,20,80,60,20,20,Direct
3527660,100,0,20,100,80,20,20,Direct
3527677,100,0,20,50,30,20,20,Direct
3527727,700,395,65,540,475,65,65,Direct
3527859,75,0,35,260,225,35,35,Direct
3528042,100,0,20,85,65,20,20,Direct
3505514,50,0,20,85,65,20,20,Direct
3506518,200,30,40,275,235,40,40,Direct
3528196,150,0,35,160,125,35,35,Direct
3528260,150,5,35,170,135,35,35,Direct
3528277,150,5,20,180,160,20,20,Direct
3528345,200,35,20,75,55,20,20,Direct
3528795,175,10,50,200,150,50,50,Direct
3514709,100,0,24,84,60,24,24,Direct
3528945,175,5,22,92,70,22,22,Direct
3529182,175,5,20,180,160,20,20,Direct
3529213,100,0,35,160,125,35,35,Direct
3529314,350,130,50,265,215,50,50,Direct
3529332,275,60,20,160,140,20,20,Direct
3529532,75,0,50,275,225,50,50,Direct
3529596,125,0,35,190,155,35,35,Direct
3529599,125,0,20,95,75,20,20,Direct
3529646,275,75,50,275,225,50,50,Direct
3529663,75,0,25,75,50,25,25,Direct
3529731,200,20,20,110,90,20,20,Direct
3529732,125,0,20,190,170,20,20,Direct
3529800,175,20,35,280,245,35,35,Direct
3529195,450,140,50,200,150,50,50,Direct
3530000,200,20,50,250,200,50,50,Direct
3530349,175,5,35,140,105,35,35,Direct
3530417,275,70,35,285,250,35,35,Direct
3530382,225,45,35,165,130,35,35,Direct
3530532,175,10,35,160,125,35,35,Direct
3531000,100,0,20,80,60,20,20,Direct
3531050,125,0,35,175,140,35,35,Direct
3531217,75,0,20,55,35,20,20,Direct
3531254,25,0,35,120,85,35,35,Direct
3562812,175,0,35,280,245,35,35,Direct
3562948,125,0,50,265,215,50,50,Direct
3562161,175,5,60,100,40,60,60,Direct
3563433,100,0,20,130,110,20,20,Direct
3563482,275,60,35,155,120,35,35,Direct
3563631,200,20,50,220,170,50,50,Direct
3561059,125,0,35,150,115,35,35,Direct
3564184,125,0,35,225,190,35,35,Direct
3564203,75,0,50,200,150,50,50,Direct
3564654,50,0,35,285,250,35,35,Direct
3565069,200,35,50,265,215,50,50,Direct
3565403,100,0,35,185,150,35,35,Direct
3486189,100,0,35,265,230,35,35,Direct
3565556,150,0,20,160,140,20,20,Direct
3566275,100,0,35,170,135,35,35,Direct
3566556,100,0,35,175,140,35,35,Direct
3566626,200,30,35,180,145,35,35,Direct
3566890,150,0,70,245,175,70,70,Direct
3566892,100,0,20,155,135,20,20,Direct
3567141,200,30,20,85,65,20,20,Direct
3567677,175,5,35,295,260,35,35,Direct
3567762,175,15,35,170,135,35,35,Direct
3567977,425,115,50,365,315,50,50,Direct
3568813,150,0,50,275,225,50,50,Direct
3568998,100,0,35,150,115,35,35,Direct
3569064,100,0,35,150,115,35,35,Direct
3569164,175,15,50,200,150,50,50,Direct
3569183,175,5,35,240,205,35,35,Direct
3569600,200,40,35,245,210,35,35,Direct
3569949,175,10,50,265,215,50,50,Direct
3570100,100,0,35,155,120,35,35,Direct
3572306,75,0,35,150,115,35,35,Direct
3573378,150,0,50,300,250,50,50,Direct
3573827,125,0,20,165,145,20,20,Direct
3529370,200,30,50,380,330,50,50,Direct
3531263,325,85,50,200,150,50,50,Direct
3531472,50,0,20,80,60,20,20,Direct
3531667,100,0,50,220,170,50,50,Direct
3531701,225,25,35,245,210,35,35,Direct
3531331,225,30,50,375,325,50,50,Direct
3532135,125,0,35,260,225,35,35,Direct
3532208,125,0,40,200,160,40,40,Direct
3532233,75,0,35,125,90,35,35,Direct
3532276,100,0,35,150,115,35,35,Direct
3532467,175,15,35,115,80,35,35,Direct
3532476,175,5,50,265,215,50,50,Direct
3532603,200,40,35,170,135,35,35,Direct
3533110,225,45,75,385,310,75,75,Direct
3533505,75,0,35,155,120,35,35,Direct
3533739,100,0,35,150,115,35,35,Direct
3533773,225,35,75,365,290,75,75,Direct
3533782,200,25,50,225,175,50,50,Direct
3533973,200,25,35,135,100,35,35,Direct
3534016,150,5,35,135,100,35,35,Direct
3534250,100,0,35,195,160,35,35,Direct
3534450,50,0,35,225,190,35,35,Direct
3534573,200,20,35,100,65,35,35,Direct
3534739,125,0,35,150,115,35,35,Direct
3519406,175,5,50,210,160,50,50,Direct
3534875,250,40,50,200,150,50,50,Direct
3534952,200,35,50,225,175,50,50,Direct
3535182,75,0,35,100,65,35,35,Direct
3535309,100,0,50,245,195,50,50,Direct
3531131,100,0,35,150,115,35,35,Direct
3535675,100,0,35,160,125,35,35,Direct
3535777,250,60,20,140,120,20,20,Direct
3535952,175,15,35,135,100,35,35,Direct
3536011,375,135,20,185,165,20,20,Direct
3536088,100,0,35,160,125,35,35,Direct
3536147,200,30,35,125,90,35,35,Direct
3536322,225,55,35,190,155,35,35,Direct
3536377,275,65,35,185,150,35,35,Direct
3512445,225,45,50,205,155,50,50,Direct
3536547,125,0,50,220,170,50,50,Direct
3536654,175,10,100,200,100,100,100,Direct
3537024,200,30,35,150,115,35,35,Direct
3537113,350,120,50,205,155,50,50,Direct
3537147,325,110,35,150,115,35,35,Direct
3537390,75,0,25,60,35,25,25,Direct
3537751,75,0,35,190,155,35,35,Direct
3537781,150,0,20,50,30,20,20,Direct
3537215,175,5,50,240,190,50,50,Direct
3538283,50,0,20,160,140,20,20,Direct
3538351,50,0,35,185,150,35,35,Direct
3538551,250,45,35,190,155,35,35,Direct
3538594,75,0,50,200,150,50,50,Direct
3538819,250,40,20,155,135,20,20,Direct
3538862,200,25,110,425,315,110,110,Direct
3538960,125,0,35,155,120,35,35,Direct
3538985,200,25,50,250,200,50,50,Direct
3539160,100,0,35,140,105,35,35,Direct
3539321,100,0,35,175,140,35,35,Direct
3533918,275,70,35,150,115,35,35,Direct
3534203,300,35,20,75,55,20,20,Direct
3534552,250,50,35,190,155,35,35,Direct
3534569,250,65,100,245,145,100,100,Direct
3535003,200,25,20,190,170,20,20,Direct
3535054,200,20,35,150,115,35,35,Direct
3535237,225,35,35,140,105,35,35,Direct
3534671,250,65,35,190,155,35,35,Direct
3535671,75,0,35,185,150,35,35,Direct
3535705,125,0,35,190,155,35,35,Direct
3535841,150,5,35,150,115,35,35,Direct
3536058,200,35,35,190,155,35,35,Direct
3536109,300,100,35,275,240,35,35,Direct
3536356,250,65,40,220,180,40,40,Direct
3536577,225,30,20,140,120,20,20,Direct
3536607,50,0,35,140,105,35,35,Direct
3525562,125,0,35,190,155,35,35,Direct
3536828,175,0,50,210,160,50,50,Direct
3537126,225,45,50,285,235,50,50,Direct
3537560,200,30,35,125,90,35,35,Direct
3537896,100,0,50,205,155,50,50,Direct
3537981,100,0,35,260,225,35,35,Direct
3536794,125,0,35,285,250,35,35,Direct
3538496,100,0,35,120,85,35,35,Direct
3538849,300,85,35,185,150,35,35,Direct
3539066,400,140,50,275,225,50,50,Direct
3539100,75,0,50,230,180,50,50,Direct
3539215,200,30,35,240,205,35,35,Direct
3539368,225,35,40,275,235,40,40,Direct
3453362,275,60,35,170,135,35,35,Direct
3539432,150,0,50,250,200,50,50,Direct
3539449,175,15,35,230,195,35,35,Direct
3539466,150,0,50,220,170,50,50,Direct
3539585,100,0,20,140,120,20,20,Direct
3539853,175,5,35,135,100,35,35,Direct
3540036,250,30,35,100,65,35,35,Direct
3540453,75,0,35,245,210,35,35,Direct
3540738,125,0,20,120,100,20,20,Direct
3540755,250,50,35,155,120,35,35,Direct
3540921,250,105,35,175,140,35,35,Direct
3541036,275,60,50,270,220,50,50,Direct
3541189,350,115,75,300,225,75,75,Direct
3541487,100,0,35,185,150,35,35,Direct
3541772,375,120,35,205,170,35,35,Direct
3542040,100,0,35,155,120,35,35,Direct
3542525,50,0,35,180,145,35,35,Direct
3542640,100,0,50,200,150,50,50,Direct
3542942,75,0,50,250,200,50,50,Direct
3543142,75,0,20,50,30,20,20,Direct
3543210,100,0,35,175,140,35,35,Direct
3543997,325,85,20,175,155,20,20,Direct
3544044,175,10,20,150,130,20,20,Direct
3544248,200,20,20,65,45,20,20,Direct
3544780,625,300,55,410,355,55,55,Direct
3544882,225,45,35,150,115,35,35,Direct
3542657,250,60,35,125,90,35,35,Direct
3541840,100,0,20,140,120,20,20,Direct
3545167,175,5,35,255,220,35,35,Direct
3510757,75,0,35,225,190,35,35,Direct
3510791,500,195,50,275,225,50,50,Direct
3511000,100,0,50,230,180,50,50,Direct
3511193,300,70,50,275,225,50,50,Direct
3511227,300,70,50,265,215,50,50,Direct
3511393,350,115,50,230,180,50,50,Direct
3511427,175,0,35,175,140,35,35,Direct
3511629,225,35,35,260,225,35,35,Direct
3512029,200,30,20,195,175,20,20,Direct
3512365,225,45,60,175,115,60,60,Direct
3512363,175,15,35,195,160,35,35,Direct
3512806,100,0,25,75,50,25,25,Direct
3512908,550,260,80,730,650,80,80,Direct
3512899,225,35,35,150,115,35,35,Direct
3512906,350,150,35,190,155,35,35,Direct
3513272,75,0,50,225,175,50,50,Direct
3513501,175,5,50,225,175,50,50,Direct
3513499,325,85,35,230,195,35,35,Direct
3513506,200,20,50,205,155,50,50,Direct
3513799,225,35,35,155,120,35,35,Direct
3513901,125,0,35,140,105,35,35,Direct
3513942,175,10,35,135,100,35,35,Direct
3513999,100,0,50,265,215,50,50,Direct
3514444,125,0,35,100,65,35,35,Direct
3514771,125,0,25,75,50,25,25,Direct
3514837,75,0,20,140,120,20,20,Direct
3514880,125,0,35,225,190,35,35,Direct
3514978,100,0,50,210,160,50,50,Direct
3515114,75,0,35,125,90,35,35,Direct
3515244,250,50,35,190,155,35,35,Direct
3514442,150,0,35,225,190,35,35,Direct
3515580,225,45,50,230,180,50,50,Direct
3515637,200,30,35,150,115,35,35,Direct
3515973,125,0,35,225,190,35,35,Direct
3516014,175,5,20,155,135,20,20,Direct
3516209,75,0,50,230,180,50,50,Direct
3516180,125,0,75,275,200,75,75,Direct
3516207,50,0,50,250,200,50,50,Direct
3516216,75,0,35,140,105,35,35,Direct
3516473,250,65,37,142,105,37,37,Direct
3516607,150,0,35,150,115,35,35,Direct
3516809,175,5,35,180,145,35,35,Direct
3516852,150,0,35,150,115,35,35,Direct
3517009,175,5,35,155,120,35,35,Direct
3517252,275,70,35,185,150,35,35,Direct
3517250,100,0,35,100,65,35,35,Direct
3517779,75,0,35,155,120,35,35,Direct
3517786,175,10,35,155,120,35,35,Direct
3518086,200,20,20,155,135,20,20,Direct
3518379,175,5,35,140,105,35,35,Direct
3518488,175,5,75,375,300,75,75,Direct
3518545,175,10,50,255,205,50,50,Direct
3518781,400,165,50,275,225,50,50,Direct
3543375,75,0,15,70,55,15,15,Direct
3543614,175,5,35,165,130,35,35,Direct
3543818,125,0,35,170,135,35,35,Direct
3543843,175,15,35,155,120,35,35,Direct
3543839,250,55,20,170,150,20,20,Direct
3544125,125,0,35,180,145,35,35,Direct
3544282,100,0,35,285,250,35,35,Direct
3544393,175,10,35,255,220,35,35,Direct
3544418,200,25,25,85,60,25,25,Direct
3544929,100,0,50,210,160,50,50,Direct
3541560,250,70,40,205,165,40,40,Direct
3542296,175,5,35,180,145,35,35,Direct
3545129,125,0,35,150,115,35,35,Direct
3545397,100,0,50,225,175,50,50,Direct
3545622,275,75,50,250,200,50,50,Direct
3545686,150,5,35,150,115,35,35,Direct
3545729,150,5,35,140,105,35,35,Direct
3545754,200,30,35,190,155,35,35,Direct
3545972,200,30,35,185,150,35,35,Direct
3545979,125,0,50,300,250,50,50,Direct
3546115,100,0,50,200,150,50,50,Direct
3546358,100,0,20,80,60,20,20,Direct
3546422,300,75,50,280,230,50,50,Direct
3546715,200,20,50,235,185,50,50,Direct
3547090,225,30,20,155,135,20,20,Direct
3455706,200,10,35,195,160,35,35,Direct
3547319,100,0,50,250,200,50,50,Direct
3547383,175,15,35,185,150,35,35,Direct
3547712,250,45,35,125,90,35,35,Direct
3548044,400,140,35,185,150,35,35,Direct
3548187,225,40,35,190,155,35,35,Direct
3548269,175,10,35,175,140,35,35,Direct
3548455,200,20,35,190,155,35,35,Direct
3548469,100,0,35,180,145,35,35,Direct
3548923,125,0,20,150,130,20,20,Direct
3538109,175,15,25,75,50,25,25,Direct
3549073,100,0,40,290,250,40,40,Direct
3549187,275,70,35,180,145,35,35,Direct
3549273,275,55,35,185,150,35,35,Direct
3549898,100,0,35,150,115,35,35,Direct
3549923,50,0,35,125,90,35,35,Direct
3550073,200,35,60,130,70,60,60,Direct
3550127,75,0,35,125,90,35,35,Direct
3550384,250,65,50,310,260,50,50,Direct
3550316,125,0,35,295,260,35,35,Direct
3550409,225,45,25,85,60,25,25,Direct
3460347,175,5,50,200,150,50,50,Direct
3550609,175,10,35,150,115,35,35,Direct
3550652,75,0,35,245,210,35,35,Direct
3550770,100,0,35,190,155,35,35,Direct
3550984,175,15,100,230,130,100,100,Direct
3551059,250,65,35,190,155,35,35,Direct
3551170,175,10,40,210,170,40,40,Direct
3551238,200,25,25,75,50,25,25,Direct
3551345,250,50,75,335,260,75,75,Direct
3551413,100,0,20,50,30,20,20,Direct
3551545,200,25,35,170,135,35,35,Direct
3551720,200,30,35,285,250,35,35,Direct
3551745,125,0,50,275,225,50,50,Direct
3551970,175,10,25,85,60,25,25,Direct
3528992,200,35,35,125,90,35,35,Direct
3552213,200,25,25,65,40,25,25,Direct
3550009,375,140,35,260,225,35,35,Direct
3553085,225,30,35,220,185,35,35,Direct
3539823,275,120,50,200,150,50,50,Direct
3539887,125,0,20,45,25,20,20,Direct
3491891,300,85,35,200,165,35,35,Direct
3539955,175,10,50,250,200,50,50,Direct
3540423,100,0,50,250,200,50,50,Direct
3540534,250,50,35,150,115,35,35,Direct
3540666,75,0,20,35,15,20,20,Direct
3540768,175,20,50,200,150,50,50,Direct
3540798,350,135,50,200,150,50,50,Direct
3512147,175,10,50,275,225,50,50,Direct
3540632,50,0,35,150,115,35,35,Direct
3541325,250,55,40,280,240,40,40,Direct
3541525,275,70,35,150,115,35,35,Direct
3541593,200,15,35,175,140,35,35,Direct
3541802,150,0,50,220,170,50,50,Direct
3541759,175,15,50,275,225,50,50,Direct
3542129,125,0,35,200,165,35,35,Direct
3542095,275,60,20,170,150,20,20,Direct
3542270,100,0,0,5,5,0,0,Direct
3542797,175,5,15,70,55,15,15,Direct
3543040,125,0,50,230,180,50,50,Direct
3543129,275,55,20,160,140,20,20,Direct
3543231,350,115,35,260,225,35,35,Direct
3543665,175,10,60,175,115,60,60,Direct
3543831,125,0,35,150,115,35,35,Direct
3543874,100,0,35,295,260,35,35,Direct
3544299,50,0,35,170,135,35,35,Direct
3544644,200,25,35,195,160,35,35,Direct
3544712,300,85,50,215,165,50,50,Direct
3545069,1675,1130,600,1820,1220,600,600,Direct
3545673,200,15,50,200,150,50,50,Direct
3545912,175,10,35,145,110,35,35,Direct
3545882,100,0,20,130,110,20,20,Direct
3546141,200,25,50,260,210,50,50,Direct
3546146,175,5,35,265,230,35,35,Direct
3485416,275,70,40,285,245,40,40,Direct
3546439,50,0,35,110,75,35,35,Direct
3546507,150,0,50,250,200,50,50,Direct
3546775,350,135,50,295,245,50,50,Direct
3546809,150,0,50,235,185,50,50,Direct
3546950,200,30,35,155,120,35,35,Direct
3546907,25,0,35,125,90,35,35,Direct
3547209,75,0,35,190,155,35,35,Direct
3547911,300,100,50,250,200,50,50,Direct
3548052,75,0,50,230,180,50,50,Direct
3548179,325,105,35,180,145,35,35,Direct
3548320,325,90,50,205,155,50,50,Direct
3548018,200,30,60,105,45,60,60,Direct
3548413,250,40,35,185,150,35,35,Direct
3548447,200,30,50,220,170,50,50,Direct
3548486,300,75,50,275,225,50,50,Direct
3548511,175,10,35,160,125,35,35,Direct
3548579,175,5,35,190,155,35,35,Direct
3548779,100,0,50,275,225,50,50,Direct
3548822,275,85,35,125,90,35,35,Direct
3548890,125,0,35,155,120,35,35,Direct
3548979,250,45,75,300,225,75,75,Direct
3549081,75,0,35,150,115,35,35,Direct
3549656,125,0,25,85,60,25,25,Direct
3549715,350,115,75,330,255,75,75,Direct
3549758,250,50,35,155,120,35,35,Direct
3549952,175,10,50,235,185,50,50,Direct
3549905,125,0,24,79,55,24,24,Direct
3541446,175,0,20,135,115,20,20,Direct
3551105,225,30,35,150,115,35,35,Direct
3551623,275,75,50,370,320,50,50,Direct
3552027,125,0,50,220,170,50,50,Direct
3552078,200,30,35,195,160,35,35,Direct
3552309,200,25,35,175,140,35,35,Direct
3552913,25,0,35,160,125,35,35,Direct
3553010,100,0,20,25,5,20,20,Direct
3553014,75,0,50,220,170,50,50,Direct
3553095,175,15,50,225,175,50,50,Direct
3545794,125,0,35,125,90,35,35,Direct
3553381,200,25,35,175,140,35,35,Direct
3553482,250,50,40,200,160,40,40,Direct
3553649,50,0,50,235,185,50,50,Direct
3553814,175,15,35,150,115,35,35,Direct
3554167,175,10,35,160,125,35,35,Direct
3554282,150,0,35,160,125,35,35,Direct
3554581,200,15,35,140,105,35,35,Direct
3474198,200,20,60,135,75,60,60,Direct
3554968,125,0,20,80,60,20,20,Direct
3555099,225,45,35,280,245,35,35,Direct
3555253,75,0,35,225,190,35,35,Direct
3555368,125,0,35,150,115,35,35,Direct
3555903,125,0,25,90,65,25,25,Direct
3556839,125,0,40,265,225,40,40,Direct
3556972,300,80,50,200,150,50,50,Direct
3557558,100,0,20,135,115,20,20,Direct
3558044,175,10,35,125,90,35,35,Direct
3558979,75,0,20,135,115,20,20,Direct
3559698,125,0,35,155,120,35,35,Direct
3559916,75,0,50,205,155,50,50,Direct
3560465,200,20,20,160,140,20,20,Direct
3560601,200,20,35,125,90,35,35,Direct
3542668,100,0,20,70,50,20,20,Direct
3560902,150,0,50,260,210,50,50,Direct
3560984,200,5,35,135,100,35,35,Direct
3561052,125,0,50,200,150,50,50,Direct
3561434,125,0,50,325,275,50,50,Direct
3561452,350,115,50,275,225,50,50,Direct
3560197,200,20,20,130,110,20,20,Direct
3561651,100,0,20,45,25,20,20,Direct
3564345,275,55,35,180,145,35,35,Direct
3562306,275,85,20,180,160,20,20,Direct
3563055,175,5,20,75,55,20,20,Direct
3563255,300,85,35,255,220,35,35,Direct
3564795,225,55,20,180,160,20,20,Direct
3564846,175,10,20,160,140,20,20,Direct
3555035,125,0,35,145,110,35,35,Direct
3565145,400,145,35,285,250,35,35,Direct
3565731,325,120,50,275,225,50,50,Direct
3565999,525,220,50,275,225,50,50,Direct
3566064,100,0,35,150,115,35,35,Direct
3566549,175,5,20,140,120,20,20,Direct
3555653,300,80,50,325,275,50,50,Direct
3567268,250,55,35,185,150,35,35,Direct
3567553,200,30,20,65,45,20,20,Direct
3568272,225,35,35,175,140,35,35,Direct
3544624,125,0,20,75,55,20,20,Direct
3544874,250,65,50,260,210,50,50,Direct
3520123,50,0,20,130,110,20,20,Direct
3545224,150,0,20,130,110,20,20,Direct
3545374,250,40,50,205,155,50,50,Direct
3545609,300,75,20,180,160,20,20,Direct
3545709,100,0,50,220,170,50,50,Direct
3546145,175,10,35,150,115,35,35,Direct
3546159,50,0,35,155,120,35,35,Direct
3546195,250,45,35,185,150,35,35,Direct
3546596,50,0,20,150,130,20,20,Direct
3546645,175,15,35,155,120,35,35,Direct
3547196,100,0,35,190,155,35,35,Direct
3464986,200,25,35,245,210,35,35,Direct
3547432,75,0,35,125,90,35,35,Direct
3547445,225,45,50,245,195,50,50,Direct
3547596,100,0,35,140,105,35,35,Direct
3547796,75,0,50,275,225,50,50,Direct
3548368,125,0,35,190,155,35,35,Direct
3548417,475,165,50,275,225,50,50,Direct
3548481,175,0,20,50,30,20,20,Direct
3527961,225,45,35,150,115,35,35,Direct
3549168,175,10,35,150,115,35,35,Direct
3549367,100,0,35,210,175,35,35,Direct
3549517,375,120,75,340,265,75,75,Direct
3549653,200,25,35,170,135,35,35,Direct
3549604,225,35,20,180,160,20,20,Direct
3549768,225,45,20,180,160,20,20,Direct
3549803,225,35,35,220,185,35,35,Direct
3550039,25,0,35,235,200,35,35,Direct
3550353,325,105,50,200,150,50,50,Direct
3550454,300,85,50,230,180,50,50,Direct
3550975,75,0,50,250,200,50,50,Direct
3551025,100,0,35,235,200,35,35,Direct
3551039,175,0,40,210,170,40,40,Direct
3551289,200,15,50,235,185,50,50,Direct
3551439,125,0,20,165,145,20,20,Direct
3551576,175,10,35,185,150,35,35,Direct
3551776,175,15,35,190,155,35,35,Direct
3551825,375,120,50,270,220,50,50,Direct
3552126,175,20,50,325,275,50,50,Direct
3552376,175,10,50,205,155,50,50,Direct
3530684,175,5,20,180,160,20,20,Direct
3552676,125,0,25,75,50,25,25,Direct
3543702,175,10,35,185,150,35,35,Direct
3532320,275,40,35,150,115,35,35,Direct
3553097,375,120,50,375,325,50,50,Direct
3553197,75,0,45,150,105,45,45,Direct
3499782,175,10,50,260,210,50,50,Direct
3553597,75,0,50,225,175,50,50,Direct
3553598,275,85,35,145,110,35,35,Direct
3553797,150,0,35,150,115,35,35,Direct
3554584,100,0,35,155,120,35,35,Direct
3554933,200,30,25,95,70,25,25,Direct
3555133,75,0,25,50,25,25,25,Direct
3555183,100,0,35,100,65,35,35,Direct
3555283,225,25,35,135,100,35,35,Direct
3555320,100,0,35,150,115,35,35,Direct
3555319,50,0,35,235,200,35,35,Direct
3555520,150,0,35,105,70,35,35,Direct
3536639,225,45,50,250,200,50,50,Direct
3536803,175,10,35,165,130,35,35,Direct
3536832,225,40,35,185,150,35,35,Direct
3537482,150,0,35,155,120,35,35,Direct
3537582,250,65,40,220,180,40,40,Direct
3537632,75,0,35,120,85,35,35,Direct
3537739,150,5,20,160,140,20,20,Direct
3538068,175,10,20,95,75,20,20,Direct
3527536,175,20,50,200,150,50,50,Direct
3538361,225,35,50,220,170,50,50,Direct
3538411,50,0,35,250,215,35,35,Direct
3539054,200,20,35,185,150,35,35,Direct
3539068,225,35,35,155,120,35,35,Direct
3539111,25,0,25,50,25,25,25,Direct
3539247,125,0,50,220,170,50,50,Direct
3539661,175,0,35,150,115,35,35,Direct
3518548,175,5,35,145,110,35,35,Direct
3540540,250,45,35,230,195,35,35,Direct
3540640,375,130,50,215,165,50,50,Direct
3523049,250,60,35,165,130,35,35,Direct
3540683,200,25,35,155,120,35,35,Direct
3533388,300,75,35,150,115,35,35,Direct
3540783,275,90,75,325,250,75,75,Direct
3540926,550,245,110,485,375,110,110,Direct
3540990,200,15,40,325,285,40,40,Direct
3541033,175,10,35,165,130,35,35,Direct
3541076,150,0,35,100,65,35,35,Direct
3541169,175,10,35,230,195,35,35,Direct
3541183,125,0,50,215,165,50,50,Direct
3541219,175,10,35,170,135,35,35,Direct
3541619,75,0,35,150,115,35,35,Direct
3541676,500,195,50,280,230,50,50,Direct
3541719,50,0,35,165,130,35,35,Direct
3541819,200,15,35,150,115,35,35,Direct
3542019,175,0,35,160,125,35,35,Direct
3542076,100,0,50,300,250,50,50,Direct
3542319,175,10,35,225,190,35,35,Direct
3542512,100,0,20,85,65,20,20,Direct
3542612,1175,620,500,1485,985,500,500,Direct
3542798,200,30,50,220,170,50,50,Direct
3542898,200,15,35,255,220,35,35,Direct
3542905,75,0,35,185,150,35,35,Direct
3542962,250,45,35,150,115,35,35,Direct
3542998,325,105,35,190,155,35,35,Direct
3543255,75,0,35,150,115,35,35,Direct
3543291,200,55,35,170,135,35,35,Direct
3543505,150,0,50,275,225,50,50,Direct
3543791,0,0,35,175,140,35,35,Direct
3543491,250,65,50,265,215,50,50,Direct
3536789,100,0,50,275,225,50,50,Direct
3544234,175,5,35,225,190,35,35,Direct
3544427,325,115,35,175,140,35,35,Direct
3544727,225,45,50,250,200,50,50,Direct
3544827,25,0,35,160,125,35,35,Direct
3545027,450,145,50,275,225,50,50,Direct
3541283,300,80,35,150,115,35,35,Direct
3539261,225,45,25,80,55,25,25,Direct
3545220,375,140,50,375,325,50,50,Direct
3545420,275,75,50,225,175,50,50,Direct
3545556,275,70,50,220,170,50,50,Direct
3545277,200,20,35,145,110,35,35,Direct
3545656,125,0,35,135,100,35,35,Direct
3535635,250,50,60,145,85,60,60,Direct
3535785,175,0,50,305,255,50,50,Direct
3535835,200,25,35,140,105,35,35,Direct
3535885,200,30,35,185,150,35,35,Direct
3535985,100,0,35,190,155,35,35,Direct
3536121,275,75,20,140,120,20,20,Direct
3536271,225,75,20,120,100,20,20,Direct
3536421,75,0,15,70,55,15,15,Direct
3536857,375,150,35,190,155,35,35,Direct
3536907,125,0,35,155,120,35,35,Direct
3537114,200,30,25,95,70,25,25,Direct
3537264,125,0,20,50,30,20,20,Direct
3537500,200,30,35,150,115,35,35,Direct
3534842,225,35,50,200,150,50,50,Direct
3537614,275,90,35,155,120,35,35,Direct
3538650,75,0,35,175,140,35,35,Direct
3538729,275,75,35,220,185,35,35,Direct
3538829,175,10,35,120,85,35,35,Direct
3539043,200,30,35,135,100,35,35,Direct
3539329,100,0,20,150,130,20,20,Direct
3539372,50,0,35,180,145,35,35,Direct
3539536,200,35,35,230,195,35,35,Direct
3539779,75,0,35,185,150,35,35,Direct
3539829,100,0,35,185,150,35,35,Direct
3540029,375,140,75,350,275,75,75,Direct
3538100,150,0,20,50,30,20,20,Direct
3540358,125,0,35,140,105,35,35,Direct
3540622,50,0,25,60,35,25,25,Direct
3540908,275,75,50,265,215,50,50,Direct
3540965,150,0,20,125,105,20,20,Direct
3541194,175,10,35,160,125,35,35,Direct
3541444,75,0,35,170,135,35,35,Direct
3541687,200,35,50,200,150,50,50,Direct
3541851,50,0,36,111,75,36,36,Direct
3542087,200,30,35,150,115,35,35,Direct
3542244,175,15,50,275,225,50,50,Direct
3542280,200,15,40,205,165,40,40,Direct
3542594,250,40,35,170,135,35,35,Direct
3542630,50,0,35,175,140,35,35,Direct
3542637,275,55,35,145,110,35,35,Direct
3542887,125,0,20,75,55,20,20,Direct
3543037,375,120,20,190,170,20,20,Direct
3543430,150,0,55,170,135,35,35,Direct
3543609,125,0,50,275,225,50,50,Direct
3543666,100,0,35,160,125,35,35,Direct
3543766,475,170,40,285,245,40,40,Direct
3544102,200,30,50,375,325,50,50,Direct
3544209,350,125,50,375,325,50,50,Direct
3544595,225,45,20,160,140,20,20,Direct
3545138,200,30,24,99,75,24,24,Direct
3545295,175,5,35,180,145,35,35,Direct
3545395,150,0,40,220,180,40,40,Direct
3450910,325,120,75,350,275,75,75,Direct
3545731,200,20,60,185,125,60,60,Direct
3545831,175,15,50,210,160,50,50,Direct
3546038,50,0,35,150,115,35,35,Direct
3545197,325,105,35,160,125,35,35,Direct
3545333,175,0,50,225,175,50,50,Direct
3545533,150,0,35,175,140,35,35,Direct
3545784,125,0,35,140,105,35,35,Direct
3545852,200,25,35,165,130,35,35,Direct
3545967,125,0,35,155,120,35,35,Direct
3546571,125,0,35,125,90,35,35,Direct
3546971,200,20,50,285,235,50,50,Direct
3547086,100,0,35,195,160,35,35,Direct
3547273,50,0,20,35,15,20,20,Direct
3547371,300,85,50,220,170,50,50,Direct
3546669,200,20,20,140,120,20,20,Direct
3547507,75,0,35,110,75,35,35,Direct
3547554,325,90,50,240,190,50,50,Direct
3547741,75,0,50,220,170,50,50,Direct
3547873,100,0,35,190,155,35,35,Direct
3548039,200,25,35,155,120,35,35,Direct
3548124,150,0,50,380,330,50,50,Direct
3548690,75,0,25,95,70,25,25,Direct
3548741,225,45,50,275,225,50,50,Direct
3548941,175,10,35,125,90,35,35,Direct
3549026,50,0,50,205,155,50,50,Direct
3549111,300,95,50,225,175,50,50,Direct
3549345,325,120,50,220,170,50,50,Direct
3549545,125,0,20,145,125,20,20,Direct
3550966,150,0,35,190,155,35,35,Direct
3551183,375,155,50,230,180,50,50,Direct
3551349,125,0,50,305,255,50,50,Direct
3551468,225,60,100,200,100,100,100,Direct
3551885,275,90,20,170,150,20,20,Direct
3552353,75,0,35,190,155,35,35,Direct
3552434,275,60,50,220,170,50,50,Direct
3552638,175,5,35,175,140,35,35,Direct
3552804,100,0,35,140,105,35,35,Direct
3545886,175,15,35,150,115,35,35,Direct
3553136,375,150,50,325,275,50,50,Direct
3553404,250,50,50,255,205,50,50,Direct
3553689,150,0,50,200,150,50,50,Direct
3553774,100,0,35,105,70,35,35,Direct
3553906,350,115,50,300,250,50,50,Direct
3553957,200,30,40,240,200,40,40,Direct
3554025,175,10,35,155,120,35,35,Direct
3553940,175,0,35,125,90,35,35,Direct
3554323,250,65,35,185,150,35,35,Direct
3554272,100,0,35,290,255,35,35,Direct
3554910,25,0,25,90,65,25,25,Direct
3554974,200,30,35,150,115,35,35,Direct
3516687,125,0,35,265,230,35,35,Direct
3556931,150,0,35,170,135,35,35,Direct
3557114,100,0,35,120,85,35,35,Direct
3557514,200,20,20,85,65,20,20,Direct
3557782,200,30,50,260,210,50,50,Direct
3558084,125,0,35,115,80,35,35,Direct
3556348,100,0,35,180,145,35,35,Direct
3567518,100,0,50,225,175,50,50,Direct
3568872,75,0,40,240,200,40,40,Direct
3542735,250,55,35,235,200,35,35,Direct
3569089,200,40,35,185,150,35,35,Direct
3569407,150,5,20,85,65,20,20,Direct
3569408,200,30,35,190,155,35,35,Direct
3569475,225,35,75,350,275,75,75,Direct
3570075,125,0,35,120,85,35,35,Direct
3570676,200,15,50,265,215,50,50,Direct
3570926,125,0,20,85,65,20,20,Direct
3571615,325,105,50,220,170,50,50,Direct
3571748,125,0,35,225,190,35,35,Direct
3564978,175,5,35,190,155,35,35,Direct
3572015,175,10,50,230,180,50,50,Direct
3573569,175,15,50,375,325,50,50,Direct
3531267,450,140,75,350,275,75,75,Direct
3531271,100,0,50,250,200,50,50,Direct
3531404,200,30,20,160,140,20,20,Direct
3531586,200,15,25,95,70,25,25,Direct
3524651,250,40,20,160,140,20,20,Direct
3510879,325,155,50,220,170,50,50,Direct
3532203,400,125,35,190,155,35,35,Direct
3532407,225,30,20,75,55,20,20,Direct
3532421,225,15,35,160,125,35,35,Direct
3532540,200,25,20,85,65,20,20,Direct
3522997,125,0,25,75,50,25,25,Direct
3532872,200,20,35,115,80,35,35,Direct
3532957,350,125,35,160,125,35,35,Direct
3533008,175,10,50,325,275,50,50,Direct
3533276,150,0,50,225,175,50,50,Direct
3533390,200,30,35,250,215,35,35,Direct
3533408,150,0,35,150,115,35,35,Direct
3533425,125,0,35,245,210,35,35,Direct
3533493,175,10,35,125,90,35,35,Direct
3533944,250,45,35,105,70,35,35,Direct
3534025,175,10,35,180,145,35,35,Direct
3534279,175,15,35,200,165,35,35,Direct
3534811,275,85,50,340,290,50,50,Direct
3534829,125,0,35,190,155,35,35,Direct
3535365,250,65,35,125,90,35,35,Direct
3535130,175,10,25,70,45,25,25,Direct
3532003,175,0,35,190,155,35,35,Direct
3530485,100,0,35,155,120,35,35,Direct
3535748,150,5,35,295,260,35,35,Direct
3529281,75,0,20,155,135,20,20,Direct
3536151,75,0,50,275,225,50,50,Direct
3536084,125,0,50,230,180,50,50,Direct
3536283,75,0,35,150,115,35,35,Direct
3536415,150,0,20,170,150,20,20,Direct
3536501,125,0,50,230,180,50,50,Direct
3536484,100,0,35,155,120,35,35,Direct
3537033,175,0,20,185,165,20,20,Direct
3537084,225,30,50,200,150,50,50,Direct
3537270,175,10,50,240,190,50,50,Direct
3537301,325,105,50,220,170,50,50,Direct
3537687,175,15,50,275,225,50,50,Direct
3537705,125,0,50,220,170,50,50,Direct
3537738,150,0,35,225,190,35,35,Direct
3537802,400,165,50,325,275,50,50,Direct
3535880,200,35,50,215,165,50,50,Direct
3538006,125,0,35,160,125,35,35,Direct
3538555,200,30,35,295,260,35,35,Direct
3538888,225,45,20,140,120,20,20,Direct
3538905,125,0,20,140,120,20,20,Direct
3539342,175,0,35,155,120,35,35,Direct
3539491,100,0,20,170,150,20,20,Direct
3539559,100,0,35,180,145,35,35,Direct
3539959,575,265,75,395,320,75,75,Direct
3540045,50,0,35,125,90,35,35,Direct
3540445,300,145,35,145,110,35,35,Direct
3540577,275,75,35,140,105,35,35,Direct
3549817,100,0,35,150,115,35,35,Direct
3549826,150,0,35,155,120,35,35,Direct
3550017,150,0,60,135,75,60,60,Direct
3550251,50,0,35,140,105,35,35,Direct
3550349,100,0,35,130,95,35,35,Direct
3550592,200,15,35,175,140,35,35,Direct
3550694,50,0,35,140,105,35,35,Direct
3550758,225,25,35,140,105,35,35,Direct
3550826,200,20,50,385,335,50,50,Direct
3551060,125,0,50,235,185,50,50,Direct
3481663,75,0,35,160,125,35,35,Direct
3551260,200,20,35,135,100,35,35,Direct
3551421,175,5,35,150,115,35,35,Direct
3551664,200,30,35,185,150,35,35,Direct
3551753,275,70,40,210,170,40,40,Direct
3550719,100,0,20,140,120,20,20,Direct
3552498,150,0,50,225,175,50,50,Direct
3552600,200,20,40,200,160,40,40,Direct
3552859,200,25,35,145,110,35,35,Direct
3541202,200,25,35,135,100,35,35,Direct
3528064,50,0,20,60,40,20,20,Direct
3553025,250,65,35,150,115,35,35,Direct
3553166,225,35,50,285,235,50,50,Direct
3553098,250,40,50,235,185,50,50,Direct
3553527,100,0,25,55,30,25,25,Direct
3553566,75,0,35,150,115,35,35,Direct
3554093,125,0,20,160,140,20,20,Direct
3554068,375,135,110,440,330,110,110,Direct
3554161,100,0,35,125,90,35,35,Direct
3554463,75,0,35,170,135,35,35,Direct
3554697,150,0,35,155,120,35,35,Direct
3554770,175,15,35,280,245,35,35,Direct
3554829,175,10,50,220,170,50,50,Direct
3555038,325,125,75,330,255,75,75,Direct
3555072,175,15,35,125,90,35,35,Direct
3555297,175,5,35,155,120,35,35,Direct
3555331,175,10,35,175,140,35,35,Direct
3555667,200,30,60,195,135,60,60,Direct
3556165,125,0,35,160,125,35,35,Direct
3556267,50,0,20,45,25,20,20,Direct
3556803,175,5,35,150,115,35,35,Direct
3556833,100,0,20,160,140,20,20,Direct
3556978,225,35,35,150,115,35,35,Direct
3557310,125,0,50,210,160,50,50,Direct
3557637,100,0,20,140,120,20,20,Direct
3557671,150,5,35,145,110,35,35,Direct
3557714,175,10,35,155,120,35,35,Direct
3557978,175,15,50,220,170,50,50,Direct
3514258,275,95,35,155,120,35,35,Direct
3558650,175,0,35,230,195,35,35,Direct
3559684,150,0,35,180,145,35,35,Direct
3533539,50,0,35,170,135,35,35,Direct
3560518,125,0,20,170,150,20,20,Direct
3561113,175,10,50,275,225,50,50,Direct
3561245,150,0,50,220,170,50,50,Direct
3561747,175,5,35,125,90,35,35,Direct
3561956,225,15,20,85,65,20,20,Direct
3562092,100,0,35,155,120,35,35,Direct
3562156,75,0,25,55,30,25,25,Direct
3562283,225,30,35,245,210,35,35,Direct
3562551,175,15,50,205,155,50,50,Direct
3562985,225,30,35,165,130,35,35,Direct
3563087,475,220,125,570,445,125,125,Direct
3518958,125,0,40,260,220,40,40,Direct
3519124,100,0,20,80,60,20,20,Direct
3519115,150,0,35,225,190,35,35,Direct
3519258,100,0,35,240,205,35,35,Direct
3519217,425,120,125,500,375,125,125,Direct
3519417,100,0,50,280,230,50,50,Direct
3519515,175,5,35,150,115,35,35,Direct
3519824,200,20,20,170,150,20,20,Direct
3515337,175,0,20,160,140,20,20,Direct
3516986,100,0,20,170,150,20,20,Direct
3513565,175,10,35,155,120,35,35,Direct
3520160,250,50,50,260,210,50,50,Direct
3520317,300,90,50,225,175,50,50,Direct
3520417,75,0,20,45,25,20,20,Direct
3520487,275,45,50,250,200,50,50,Direct
3520787,175,10,20,140,120,20,20,Direct
3520894,375,135,50,260,210,50,50,Direct
3520860,225,35,25,75,50,25,25,Direct
3521289,200,25,35,160,125,35,35,Direct
3521453,250,50,50,200,150,50,50,Direct
3521587,250,40,35,245,210,35,35,Direct
3521732,400,115,50,275,225,50,50,Direct
3521832,175,10,20,195,175,20,20,Direct
3521896,175,10,50,240,190,50,50,Direct
3521930,125,0,35,120,85,35,35,Direct
3521966,75,0,35,150,115,35,35,Direct
3521996,150,0,35,180,145,35,35,Direct
3522230,200,30,35,185,150,35,35,Direct
3522325,150,0,35,175,140,35,35,Direct
3522266,300,70,20,95,75,20,20,Direct
3522866,50,0,50,200,150,50,50,Direct
3522925,250,55,50,220,170,50,50,Direct
3523295,200,10,35,225,190,35,35,Direct
3520960,175,5,20,170,150,20,20,Direct
3523559,200,20,60,195,135,60,60,Direct
3523938,125,0,35,170,135,35,35,Direct
3523961,175,15,35,180,145,35,35,Direct
3523997,300,100,48,243,195,48,48,Direct
3519860,75,0,35,160,125,35,35,Direct
3507147,350,85,35,150,115,35,35,Direct
3524161,75,0,20,110,90,20,20,Direct
3524231,175,15,20,170,150,20,20,Direct
3524640,225,35,50,245,195,50,50,Direct
3524774,25,0,35,195,160,35,35,Direct
3524904,225,35,35,125,90,35,35,Direct
3525231,200,15,35,225,190,35,35,Direct
3525397,100,0,35,155,120,35,35,Direct
3525433,100,0,35,125,90,35,35,Direct
3525767,75,0,35,160,125,35,35,Direct
3525874,250,45,50,245,195,50,50,Direct
3525933,175,10,50,375,325,50,50,Direct
3525967,75,0,25,75,50,25,25,Direct
3525976,175,0,50,210,160,50,50,Direct
3526010,200,20,37,127,90,37,37,Direct
3526069,150,0,20,80,60,20,20,Direct
3526174,375,135,20,190,170,20,20,Direct
3526310,125,0,20,90,70,20,20,Direct
3525567,100,0,35,140,105,35,35,Direct
3526776,200,20,35,260,225,35,35,Direct
3526810,175,15,50,325,275,50,50,Direct
3526905,150,0,35,260,225,35,35,Direct
3545963,100,0,35,150,115,35,35,Direct
3546049,175,5,20,190,170,20,20,Direct
3546020,150,0,35,265,230,35,35,Direct
3546306,100,0,5,10,5,5,5,Direct
3546399,275,60,20,110,90,20,20,Direct
3546792,175,10,25,80,55,25,25,Direct
3547199,150,0,50,200,150,50,50,Direct
3547485,175,20,35,260,225,35,35,Direct
3547492,100,0,25,70,45,25,25,Direct
3547635,400,145,75,350,275,75,75,Direct
3547742,200,25,59,134,75,59,59,Direct
3547578,175,10,50,240,190,50,50,Direct
3548235,125,0,50,260,210,50,50,Direct
3548421,100,0,35,190,155,35,35,Direct
3548578,200,25,35,185,150,35,35,Direct
3548778,200,15,20,45,25,20,20,Direct
3548864,200,10,35,190,155,35,35,Direct
3527679,225,45,35,135,100,35,35,Direct
3526143,200,10,35,165,130,35,35,Direct
3549257,100,0,20,110,90,20,20,Direct
3549407,300,85,40,275,235,40,40,Direct
3549650,250,65,35,175,140,35,35,Direct
3549607,200,20,35,280,245,35,35,Direct
3549707,175,10,35,125,90,35,35,Direct
3546699,350,135,20,190,170,20,20,Direct
3550143,200,30,50,360,310,50,50,Direct
3550157,200,30,35,150,115,35,35,Direct
3550936,100,0,35,150,115,35,35,Direct
3551086,125,0,20,130,110,20,20,Direct
3551279,50,0,35,270,235,35,35,Direct
3551343,175,5,35,170,135,35,35,Direct
3551536,50,0,35,245,210,35,35,Direct
3551772,100,0,35,160,125,35,35,Direct
3552472,250,65,35,180,145,35,35,Direct
3552615,175,10,35,195,160,35,35,Direct
3541869,75,0,35,175,140,35,35,Direct
3553058,150,5,35,125,90,35,35,Direct
3553101,250,50,35,185,150,35,35,Direct
3553251,125,0,35,195,160,35,35,Direct
3553294,175,10,20,140,120,20,20,Direct
3553901,300,70,35,155,120,35,35,Direct
3554294,200,25,35,180,145,35,35,Direct
3554344,175,10,50,225,175,50,50,Direct
3554694,175,15,20,110,90,20,20,Direct
3554744,100,0,25,80,55,25,25,Direct
3554930,150,0,35,150,115,35,35,Direct
3555230,150,5,35,170,135,35,35,Direct
3555580,200,30,50,230,180,50,50,Direct
3555730,150,0,50,210,160,50,50,Direct
3555823,100,0,35,160,125,35,35,Direct
3556109,175,5,20,95,75,20,20,Direct
3556252,50,0,35,185,150,35,35,Direct
3556995,100,0,20,175,155,20,20,Direct
3557152,175,15,35,150,115,35,35,Direct
3557159,200,15,35,270,235,35,35,Direct
3557252,175,15,35,110,75,35,35,Direct
3557395,50,0,35,115,80,35,35,Direct
3557552,100,0,35,150,115,35,35,Direct
3557602,50,0,35,145,110,35,35,Direct
3553106,75,0,35,175,140,35,35,Direct
3553374,175,10,35,140,105,35,35,Direct
3553953,225,35,20,140,120,20,20,Direct
3546308,50,0,50,325,275,50,50,Direct
3554196,200,30,35,135,100,35,35,Direct
3554335,125,0,25,75,50,25,25,Direct
3554553,150,0,35,200,165,35,35,Direct
3555407,150,5,35,125,90,35,35,Direct
3555464,225,30,20,180,160,20,20,Direct
3555675,25,0,35,205,170,35,35,Direct
3555732,225,30,40,235,195,40,40,Direct
3556025,150,0,20,140,120,20,20,Direct
3556118,50,0,25,60,35,25,25,Direct
3556425,25,0,35,150,115,35,35,Direct
3542235,225,35,35,145,110,35,35,Direct
3526141,25,0,20,85,65,20,20,Direct
3556586,200,15,60,185,125,60,60,Direct
3556943,275,75,50,325,275,50,50,Direct
3557497,175,10,20,180,160,20,20,Direct
3558147,175,10,35,125,90,35,35,Direct
3558122,125,0,35,290,255,35,35,Direct
3558922,275,60,50,230,180,50,50,Direct
3559258,100,0,60,160,100,60,60,Direct
3559433,350,120,50,275,225,50,50,Direct
3559394,300,75,50,200,150,50,50,Direct
3559476,200,25,20,140,120,20,20,Direct
3559819,75,0,35,160,125,35,35,Direct
3560012,200,40,35,160,125,35,35,Direct
3560101,225,25,35,175,140,35,35,Direct
3560194,175,10,20,140,120,20,20,Direct
3560419,150,0,35,240,205,35,35,Direct
3560530,75,0,20,60,40,20,20,Direct
3560569,75,0,40,280,240,40,40,Direct
3557940,175,15,35,160,125,35,35,Direct
3560837,75,0,20,110,90,20,20,Direct
3560905,200,35,35,195,160,35,35,Direct
3561080,200,30,35,255,220,35,35,Direct
3561087,75,0,35,135,100,35,35,Direct
3561198,150,5,35,180,145,35,35,Direct
3561616,150,0,50,220,170,50,50,Direct
3561623,75,0,35,225,190,35,35,Direct
3561884,100,0,20,140,120,20,20,Direct
3562173,125,0,35,155,120,35,35,Direct
3562359,250,40,35,135,100,35,35,Direct
3562377,225,25,35,260,225,35,35,Direct
3563152,200,35,20,170,150,20,20,Direct
3563445,275,70,75,330,255,75,75,Direct
3564006,275,85,35,180,145,35,35,Direct
3564824,175,5,35,175,140,35,35,Direct
3565385,150,5,35,100,65,35,35,Direct
3565853,375,105,35,190,155,35,35,Direct
3565917,125,0,35,200,165,35,35,Direct
3544968,75,0,20,75,55,20,20,Direct
3566410,100,0,35,165,130,35,35,Direct
3567346,100,0,60,165,105,60,60,Direct
3568193,175,5,35,135,100,35,35,Direct
3567589,350,100,35,195,160,35,35,Direct
3560412,200,30,35,150,115,35,35,Direct
3568975,175,10,50,285,235,50,50,Direct
3569100,225,60,40,200,160,40,40,Direct
3558752,225,45,35,100,65,35,35,Direct
3558786,25,0,35,225,190,35,35,Direct
3490381,275,80,35,190,155,35,35,Direct
3558501,300,75,35,195,160,35,35,Direct
3559339,100,0,20,130,110,20,20,Direct
3559471,75,0,35,130,95,35,35,Direct
3560492,175,0,50,240,190,50,50,Direct
3560675,325,105,50,225,175,50,50,Direct
3560692,200,30,35,180,145,35,35,Direct
3560777,100,0,35,155,120,35,35,Direct
3560960,150,0,50,250,200,50,50,Direct
3561611,275,85,35,180,145,35,35,Direct
3561628,75,0,35,195,160,35,35,Direct
3561994,75,0,35,180,145,35,35,Direct
3562462,250,25,50,205,155,50,50,Direct
3563466,125,0,20,120,100,20,20,Direct
3562045,75,0,20,75,55,20,20,Direct
3564453,450,140,50,240,190,50,50,Direct
3564487,100,0,20,85,65,20,20,Direct
3564670,275,75,20,170,150,20,20,Direct
3565002,175,0,35,200,165,35,35,Direct
3564921,100,0,20,160,140,20,20,Direct
3565036,175,5,24,84,60,24,24,Direct
3565423,100,0,50,240,190,50,50,Direct
3565470,150,5,35,150,115,35,35,Direct
3565572,200,15,50,230,180,50,50,Direct
3565789,175,5,35,160,125,35,35,Direct
3565938,250,60,50,275,225,50,50,Direct
3566223,175,10,35,150,115,35,35,Direct
3566206,200,25,60,185,125,60,60,Direct
3566274,175,10,60,160,100,60,60,Direct
3566355,200,15,35,150,115,35,35,Direct
3566474,175,20,35,165,130,35,35,Direct
3566657,200,25,35,195,160,35,35,Direct
3566810,250,65,35,150,115,35,35,Direct
3567393,175,15,35,255,220,35,35,Direct
3567478,175,10,35,190,155,35,35,Direct
3567661,150,5,35,185,150,35,35,Direct
3566108,225,45,20,195,175,20,20,Direct
3512909,300,75,50,275,225,50,50,Direct
3568163,125,0,35,125,90,35,35,Direct
3568529,100,0,35,155,120,35,35,Direct
3568848,100,0,50,275,225,50,50,Direct
3569031,175,15,35,185,150,35,35,Direct
3569350,175,10,50,260,210,50,50,Direct
3569882,100,0,60,100,40,60,60,Direct
3569933,125,0,40,275,235,40,40,Direct
3572856,200,25,20,185,165,20,20,Direct
3567525,175,10,50,200,150,50,50,Direct
3560441,200,30,35,225,190,35,35,Direct
3573779,125,0,35,165,130,35,35,Direct
3563453,300,85,50,265,215,50,50,Direct
3561990,200,25,60,110,50,60,60,Direct
3564934,200,40,75,375,300,75,75,Direct
3564964,125,0,35,295,260,35,35,Direct
3564989,150,5,35,140,105,35,35,Direct
3564730,75,0,50,210,160,50,50,Direct
3565368,100,0,50,245,195,50,50,Direct
3560854,75,0,35,150,115,35,35,Direct
3565959,100,0,35,100,65,35,35,Direct
3566338,175,15,35,170,135,35,35,Direct
3566538,175,5,35,140,105,35,35,Direct
3566597,75,0,35,100,65,35,35,Direct
3567129,475,165,35,295,260,35,35,Direct
3567440,175,5,35,145,110,35,35,Direct
3567465,125,0,20,75,55,20,20,Direct
3567597,150,0,35,170,135,35,35,Direct
3567640,50,0,50,240,190,50,50,Direct
3568976,300,90,20,180,160,20,20,Direct
3569137,200,50,35,145,110,35,35,Direct
3569780,425,140,20,185,165,20,20,Direct
3569839,150,0,35,150,115,35,35,Direct
3570214,100,0,35,170,135,35,35,Direct
3570873,175,10,75,300,225,75,75,Direct
3571048,75,0,35,185,150,35,35,Direct
3571175,225,80,35,165,130,35,35,Direct
3571809,175,15,35,185,150,35,35,Direct
3572150,200,20,20,85,65,20,20,Direct
3572754,50,0,35,160,125,35,35,Direct
3572847,225,40,35,275,240,35,35,Direct
3573379,150,0,35,245,210,35,35,Direct
3573983,25,0,35,175,140,35,35,Direct
3540981,300,95,35,150,115,35,35,Direct
3541096,300,95,35,190,155,35,35,Direct
3506217,275,60,50,275,225,50,50,Direct
3541228,50,0,60,150,90,60,60,Direct
3541245,100,0,35,225,190,35,35,Direct
3541214,250,50,50,235,185,50,50,Direct
3541231,175,15,50,200,150,50,50,Direct
3541346,225,30,50,255,205,50,50,Direct
3541414,100,0,50,205,155,50,50,Direct
3541496,225,45,50,225,175,50,50,Direct
3468781,175,15,20,190,170,20,20,Direct
3542167,350,150,50,325,275,50,50,Direct
3542418,175,15,35,185,150,35,35,Direct
3542750,225,45,35,170,135,35,35,Direct
3543103,175,10,50,160,110,50,50,Direct
3543236,175,10,20,75,55,20,20,Direct
3543235,200,25,35,160,125,35,35,Direct
3543304,225,35,50,220,170,50,50,Direct
3543368,125,0,35,190,155,35,35,Direct
3543367,75,0,15,70,55,15,15,Direct
3543618,50,0,35,175,140,35,35,Direct
3544103,475,195,75,370,295,75,75,Direct
3544086,200,40,35,155,120,35,35,Direct
3544154,200,35,35,160,125,35,35,Direct
3544253,75,0,35,150,115,35,35,Direct
3544371,250,50,35,135,100,35,35,Direct
3544372,275,70,50,260,210,50,50,Direct
3544707,475,160,50,255,205,50,50,Direct
3544989,375,160,50,220,170,50,50,Direct
3545290,175,10,35,190,155,35,35,Direct
3545490,100,0,35,150,115,35,35,Direct
3545457,225,45,50,275,225,50,50,Direct
3545576,300,100,110,480,370,110,110,Direct
3503877,325,105,35,170,135,35,35,Direct
3545975,225,40,40,285,245,40,40,Direct
3545826,525,220,50,380,330,50,50,Direct
3545911,175,10,35,145,110,35,35,Direct
3545958,225,25,35,115,80,35,35,Direct
3546125,475,195,150,375,225,150,150,Direct
3546294,75,0,35,110,75,35,35,Direct
3546393,300,90,110,400,290,110,110,Direct
3546529,125,0,20,90,70,20,20,Direct
3546576,100,0,35,125,90,35,35,Direct
3545775,225,25,25,65,40,25,25,Direct
3546711,175,10,20,50,30,20,20,Direct
3546779,225,30,50,270,220,50,50,Direct
3546780,125,0,35,180,145,35,35,Direct
3546929,100,0,50,225,175,50,50,Direct
3547112,225,30,50,210,160,50,50,Direct
3547061,125,0,35,190,155,35,35,Direct
3547397,50,0,35,180,145,35,35,Direct
3547465,150,0,60,180,120,60,60,Direct
3547515,325,105,50,230,180,50,50,Direct
3547779,450,145,55,490,435,55,55,Direct
3547766,175,15,35,190,155,35,35,Direct
3546494,200,20,35,180,145,35,35,Direct
3548234,75,0,35,170,135,35,35,Direct
3548183,225,30,35,130,95,35,35,Direct
3548265,175,0,35,180,145,35,35,Direct
3548702,475,190,40,245,205,40,40,Direct
3548733,125,0,20,45,25,20,20,Direct
3548902,100,0,20,80,60,20,20,Direct
3548919,75,0,25,70,45,25,25,Direct
3548983,200,15,35,190,155,35,35,Direct
3527010,225,25,34,184,150,34,34,Direct
3527203,75,0,35,210,175,35,35,Direct
3527212,125,0,34,179,145,34,34,Direct
3527605,100,0,35,180,145,35,35,Direct
3527805,400,140,50,285,235,50,50,Direct
3527639,125,0,35,155,120,35,35,Direct
3504384,50,0,35,150,115,35,35,Direct
3528239,225,55,50,230,180,50,50,Direct
3528282,200,15,20,75,55,20,20,Direct
3528439,125,0,35,100,65,35,35,Direct
3528539,150,0,35,150,115,35,35,Direct
3528582,100,0,35,170,135,35,35,Direct
3528748,125,0,50,230,180,50,50,Direct
3528877,175,25,50,230,180,50,50,Direct
3528884,125,0,35,150,115,35,35,Direct
3529077,200,25,35,180,145,35,35,Direct
3529484,275,75,50,220,170,50,50,Direct
3529511,50,0,20,95,75,20,20,Direct
3529620,150,0,20,180,160,20,20,Direct
3529654,200,15,35,140,105,35,35,Direct
3529711,475,190,110,475,365,110,110,Direct
3530120,100,0,20,75,55,20,20,Direct
3530954,75,0,35,160,125,35,35,Direct
3531049,175,5,50,235,185,50,50,Direct
3531549,125,0,35,185,150,35,35,Direct
3531683,175,10,60,130,70,60,60,Direct
3531690,200,30,35,135,100,35,35,Direct
3531783,125,0,25,55,30,25,25,Direct
3531849,300,75,35,135,100,35,35,Direct
3531985,250,105,50,210,160,50,50,Direct
3521687,75,0,35,175,140,35,35,Direct
3532562,100,0,35,150,115,35,35,Direct
3532985,50,0,20,130,110,20,20,Direct
3533262,175,10,35,175,140,35,35,Direct
3533321,50,0,35,125,90,35,35,Direct
3533862,100,0,20,140,120,20,20,Direct
3533955,225,40,50,270,220,50,50,Direct
3440106,150,0,35,150,115,35,35,Direct
3534155,275,75,50,220,170,50,50,Direct
3534198,100,0,35,225,190,35,35,Direct
3534257,100,0,35,265,230,35,35,Direct
3534355,100,0,35,190,155,35,35,Direct
3534298,175,5,50,250,200,50,50,Direct
3534455,125,0,20,75,55,20,20,Direct
3534557,225,35,50,375,325,50,50,Direct
3534698,175,0,35,185,150,35,35,Direct
3534791,125,0,20,125,105,20,20,Direct
3534893,175,15,35,170,135,35,35,Direct
3534927,0,0,20,135,115,20,20,Direct
3535236,175,5,20,85,65,20,20,Direct
3535293,50,0,35,265,230,35,35,Direct
3535391,250,55,50,240,190,50,50,Direct
3531949,250,60,50,210,160,50,50,Direct
3533621,225,50,35,140,105,35,35,Direct
3535627,225,35,60,150,90,60,60,Direct
3535727,25,0,35,170,135,35,35,Direct
3535729,200,10,20,70,50,20,20,Direct
3535936,125,0,35,200,165,35,35,Direct
3533521,175,10,35,150,115,35,35,Direct
3555669,175,5,20,95,75,20,20,Direct
3555955,50,0,18,53,35,18,18,Direct
3546896,100,0,35,140,105,35,35,Direct
3556156,250,75,50,245,195,50,50,Direct
3556170,175,0,35,115,80,35,35,Direct
3556220,25,0,35,175,140,35,35,Direct
3556355,175,10,35,100,65,35,35,Direct
3556556,200,30,35,275,240,35,35,Direct
3552912,175,10,35,135,100,35,35,Direct
3556805,250,40,35,155,120,35,35,Direct
3557041,275,55,50,250,200,50,50,Direct
3557491,150,5,35,180,145,35,35,Direct
3558628,325,95,20,150,130,20,20,Direct
3558813,25,0,24,84,60,24,24,Direct
3558978,275,75,50,275,225,50,50,Direct
3559013,150,5,50,250,200,50,50,Direct
3559127,175,10,35,295,260,35,35,Direct
3559263,75,0,35,225,190,35,35,Direct
3559899,225,35,50,375,325,50,50,Direct
3560013,175,10,35,180,145,35,35,Direct
3560250,175,15,35,155,120,35,35,Direct
3539508,100,0,35,125,90,35,35,Direct
3560550,75,0,25,75,50,25,25,Direct
3560800,325,85,50,210,160,50,50,Direct
3560835,75,0,35,260,225,35,35,Direct
3560699,125,0,50,285,235,50,50,Direct
3561435,275,60,35,165,130,35,35,Direct
3561785,175,5,35,190,155,35,35,Direct
3562136,200,20,50,215,165,50,50,Direct
3562321,100,0,35,145,110,35,35,Direct
3562386,175,10,35,160,125,35,35,Direct
3562972,75,0,50,275,225,50,50,Direct
3563007,200,15,35,150,115,35,35,Direct
3563107,250,45,50,375,325,50,50,Direct
3563843,75,0,35,160,125,35,35,Direct
3563944,200,25,20,170,150,20,20,Direct
3564108,200,15,35,280,245,35,35,Direct
3551490,50,0,35,210,175,35,35,Direct
3564729,100,0,50,220,170,50,50,Direct
3564893,150,0,35,170,135,35,35,Direct
3565194,175,10,35,155,120,35,35,Direct
3565665,275,75,35,175,140,35,35,Direct
3565815,50,0,35,125,90,35,35,Direct
3565916,225,40,50,215,165,50,50,Direct
3566616,400,150,110,420,310,110,110,Direct
3567837,175,15,35,155,120,35,35,Direct
3568437,175,5,40,335,295,40,40,Direct
3568487,175,10,50,240,190,50,50,Direct
3568974,250,65,35,150,115,35,35,Direct
3568988,100,0,35,145,110,35,35,Direct
3569038,50,0,35,150,115,35,35,Direct
3569088,250,50,35,190,155,35,35,Direct
3569509,175,10,40,250,210,40,40,Direct
3563808,50,0,20,45,25,20,20,Direct
3569923,100,0,25,90,65,25,25,Direct
3571146,175,5,35,170,135,35,35,Direct
3571446,175,5,50,375,325,50,50,Direct
3557595,125,0,50,375,325,50,50,Direct
3557702,200,25,35,175,140,35,35,Direct
3557745,275,75,35,190,155,35,35,Direct
3558324,300,100,35,185,150,35,35,Direct
3558388,275,60,35,135,100,35,35,Direct
3558424,125,0,35,190,155,35,35,Direct
3558481,225,20,50,225,175,50,50,Direct
3558531,275,60,50,275,225,50,50,Direct
3558817,150,5,35,155,120,35,35,Direct
3558717,100,0,35,140,105,35,35,Direct
3558981,125,0,35,230,195,35,35,Direct
3559217,125,0,25,50,25,25,25,Direct
3559410,75,0,35,150,115,35,35,Direct
3559660,175,10,35,155,120,35,35,Direct
3560146,175,10,50,275,225,50,50,Direct
3560203,75,0,35,225,190,35,35,Direct
3554880,125,0,35,150,115,35,35,Direct
3560353,200,20,20,160,140,20,20,Direct
3560739,175,5,50,235,185,50,50,Direct
3561096,575,270,280,655,375,280,280,Direct
3561232,1250,900,550,1785,1235,550,550,Direct
3561446,100,0,50,250,200,50,50,Direct
3561682,200,15,20,175,155,20,20,Direct
3561875,225,55,75,325,250,75,75,Direct
3563468,150,0,20,75,55,20,20,Direct
3563561,450,145,35,295,260,35,35,Direct
3563897,200,30,60,140,80,60,60,Direct
3544977,175,10,20,75,55,20,20,Direct
3551029,100,0,35,140,105,35,35,Direct
3564947,125,0,35,175,140,35,35,Direct
3564976,375,135,50,275,225,50,50,Direct
3565276,425,115,35,180,145,35,35,Direct
3565869,50,0,37,132,95,37,37,Direct
3566119,225,45,20,125,105,20,20,Direct
3533495,250,45,35,255,220,35,35,Direct
3566519,125,0,35,155,120,35,35,Direct
3566755,200,30,35,175,140,35,35,Direct
3566762,175,15,20,140,120,20,20,Direct
3567262,300,100,20,170,150,20,20,Direct
3567412,200,20,35,135,100,35,35,Direct
3567541,225,45,35,110,75,35,35,Direct
3563161,350,90,50,225,175,50,50,Direct
3568491,250,60,35,245,210,35,35,Direct
3568534,25,0,35,170,135,35,35,Direct
3568641,175,10,35,155,120,35,35,Direct
3568984,25,0,40,200,160,40,40,Direct
3569020,250,65,35,180,145,35,35,Direct
3569777,150,0,35,295,260,35,35,Direct
3570999,200,15,35,245,210,35,35,Direct
3571799,25,0,35,145,110,35,35,Direct
3572292,150,0,35,220,185,35,35,Direct
3573264,75,0,35,135,100,35,35,Direct
3573950,125,0,50,200,150,50,50,Direct
3574943,175,5,20,140,120,20,20,Direct
3575336,275,75,20,175,155,20,20,Direct
3546088,75,0,50,210,160,50,50,Direct
3546181,175,10,25,85,60,25,25,Direct
3546624,175,0,50,220,170,50,50,Direct
3546681,350,130,35,195,160,35,35,Direct
3546731,225,45,35,185,150,35,35,Direct
3547274,225,35,110,455,345,110,110,Direct
3503004,225,35,40,230,190,40,40,Direct
3547760,175,0,35,190,155,35,35,Direct
3548096,125,0,50,250,200,50,50,Direct
3548203,150,0,35,160,125,35,35,Direct
3548303,225,45,35,170,135,35,35,Direct
3548546,225,30,20,55,35,20,20,Direct
3548596,200,15,25,90,65,25,25,Direct
3462285,175,5,35,175,140,35,35,Direct
3547667,225,30,25,75,50,25,25,Direct
3542394,75,0,20,130,110,20,20,Direct
3549132,175,0,25,95,70,25,25,Direct
3549339,200,25,50,205,155,50,50,Direct
3549346,75,0,20,195,175,20,20,Direct
3549396,50,0,35,155,120,35,35,Direct
3549589,475,190,50,275,225,50,50,Direct
3549632,350,100,50,260,210,50,50,Direct
3549732,150,0,35,150,115,35,35,Direct
3549739,200,30,50,300,250,50,50,Direct
3550018,125,0,20,140,120,20,20,Direct
3550325,50,0,50,250,200,50,50,Direct
3550425,200,30,25,90,65,25,25,Direct
3550411,375,150,50,245,195,50,50,Direct
3550868,25,0,35,160,125,35,35,Direct
3550961,150,0,35,100,65,35,35,Direct
3551004,175,10,50,230,180,50,50,Direct
3544166,200,20,35,175,140,35,35,Direct
3551797,100,0,35,120,85,35,35,Direct
3552347,150,0,50,260,210,50,50,Direct
3552697,200,30,40,375,335,40,40,Direct
3552104,625,345,110,475,365,110,110,Direct
3553090,200,20,50,235,185,50,50,Direct
3553126,475,165,150,385,235,150,150,Direct
3553333,125,0,35,155,120,35,35,Direct
3553340,125,0,35,190,155,35,35,Direct
3553383,350,105,75,330,255,75,75,Direct
3553833,200,25,35,185,150,35,35,Direct
3479354,225,35,35,190,155,35,35,Direct
3554169,200,30,50,220,170,50,50,Direct
3554355,175,5,35,185,150,35,35,Direct
3554619,200,20,50,325,275,50,50,Direct
3554669,250,45,35,175,140,35,35,Direct
3554912,200,25,35,230,195,35,35,Direct
3555205,250,65,35,170,135,35,35,Direct
3555262,125,0,35,170,135,35,35,Direct
3555048,200,10,20,75,55,20,20,Direct
3555291,100,0,35,265,230,35,35,Direct
3555591,100,0,20,180,160,20,20,Direct
3556084,200,20,50,245,195,50,50,Direct
3556291,200,15,50,275,225,50,50,Direct
3554612,175,15,35,140,105,35,35,Direct
3557320,200,20,40,350,310,40,40,Direct
3557513,100,0,35,180,145,35,35,Direct
3557706,225,45,20,180,160,20,20,Direct
3557756,25,0,1,6,5,1,1,Direct
3558020,175,5,20,150,130,20,20,Direct
3558249,175,0,35,195,160,35,35,Direct
3558456,200,30,35,195,160,35,35,Direct
3569150,0,0,20,70,50,20,20,Direct
3569379,175,10,35,190,155,35,35,Direct
3569618,375,150,75,350,275,75,75,Direct
3569847,75,0,35,140,105,35,35,Direct
3570036,100,0,50,280,230,50,50,Direct
3569661,125,0,35,295,260,35,35,Direct
3570640,175,15,75,300,225,75,75,Direct
3570847,175,10,35,125,90,35,35,Direct
3571826,175,10,35,170,135,35,35,Direct
3572562,225,35,50,275,225,50,50,Direct
3573580,125,0,35,160,125,35,35,Direct
3546844,250,35,35,125,90,35,35,Direct
3549183,100,0,50,275,225,50,50,Direct
3550106,175,0,35,125,90,35,35,Direct
3550387,125,0,50,220,170,50,50,Direct
3550455,350,115,35,185,150,35,35,Direct
3549434,325,85,35,160,125,35,35,Direct
3549120,150,0,35,190,155,35,35,Direct
3551191,100,0,60,190,130,60,60,Direct
3551459,25,0,35,175,140,35,35,Direct
3551727,25,0,25,75,50,25,25,Direct
3551991,200,35,50,375,325,50,50,Direct
3552141,200,30,20,95,75,20,20,Direct
3552277,200,30,35,240,205,35,35,Direct
3553064,275,70,50,255,205,50,50,Direct
3553328,175,10,35,190,155,35,35,Direct
3553396,100,0,35,190,155,35,35,Direct
3553413,250,45,50,230,180,50,50,Direct
3553982,200,25,35,145,110,35,35,Direct
3554149,175,15,35,190,155,35,35,Direct
3554582,100,0,35,160,125,35,35,Direct
3520389,175,20,35,275,240,35,35,Direct
3554718,200,30,35,140,105,35,35,Direct
3554749,200,25,50,225,175,50,50,Direct
3555000,200,15,20,120,100,20,20,Direct
3554999,225,35,20,160,140,20,20,Direct
3555335,175,15,35,175,140,35,35,Direct
3555536,150,0,35,185,150,35,35,Direct
3555604,175,20,20,180,160,20,20,Direct
3555654,100,0,35,190,155,35,35,Direct
3556607,175,5,35,120,85,35,35,Direct
3542699,125,0,35,190,155,35,35,Direct
3557543,250,50,20,185,165,20,20,Direct
3558093,100,0,35,125,90,35,35,Direct
3558343,375,125,50,275,225,50,50,Direct
3558493,225,25,50,200,150,50,50,Direct
3558561,125,0,35,170,135,35,35,Direct
3558679,75,0,35,145,110,35,35,Direct
3558693,75,0,50,275,225,50,50,Direct
3558994,350,150,50,265,215,50,50,Direct
3559229,100,0,35,100,65,35,35,Direct
3559279,375,120,110,470,360,110,110,Direct
3559497,175,15,35,170,135,35,35,Direct
3559615,175,10,50,220,170,50,50,Direct
3551992,125,0,35,150,115,35,35,Direct
3560534,75,0,50,265,215,50,50,Direct
3560666,200,25,35,165,130,35,35,Direct
3560816,200,15,50,235,185,50,50,Direct
3560815,100,0,20,170,150,20,20,Direct
3560866,100,0,50,265,215,50,50,Direct
3561134,175,5,50,255,205,50,50,Direct
3561484,125,0,35,115,80,35,35,Direct
3561552,250,50,35,150,115,35,35,Direct
3561602,200,30,35,285,250,35,35,Direct
3562019,150,5,35,125,90,35,35,Direct
3562070,225,25,35,180,145,35,35,Direct
3562152,200,35,25,90,65,25,25,Direct
3562423,100,0,60,120,60,60,60,Direct
3571846,150,0,20,65,45,20,20,Direct
3572031,125,0,35,255,220,35,35,Direct
3572282,175,5,35,150,115,35,35,Direct
3573368,175,10,20,170,150,20,20,Direct
3573503,125,0,35,150,115,35,35,Direct
3574503,250,45,35,225,190,35,35,Direct
3574789,225,40,35,190,155,35,35,Direct
3575390,175,10,20,195,175,20,20,Direct
3575876,225,35,50,275,225,50,50,Direct
3536536,200,30,35,165,130,35,35,Direct
3536563,175,10,40,205,165,40,40,Direct
3536636,150,0,20,75,55,20,20,Direct
3536672,100,0,50,220,170,50,50,Direct
3537063,425,120,50,220,170,50,50,Direct
3537129,350,100,40,225,185,40,40,Direct
3537599,175,5,35,185,150,35,35,Direct
3537699,175,10,20,40,20,20,20,Direct
3538235,325,90,50,220,170,50,50,Direct
3538342,125,0,35,175,140,35,35,Direct
3538544,150,0,20,90,70,20,20,Direct
3538608,225,25,40,250,210,40,40,Direct
3538678,75,0,35,155,120,35,35,Direct
3538778,50,0,35,175,140,35,35,Direct
3539037,225,45,35,185,150,35,35,Direct
3539080,200,35,35,145,110,35,35,Direct
3539371,100,0,35,180,145,35,35,Direct
3539773,225,35,50,260,210,50,50,Direct
3535670,175,0,35,185,150,35,35,Direct
3540307,200,10,35,125,90,35,35,Direct
3519281,275,60,35,145,110,35,35,Direct
3512506,250,50,35,130,95,35,35,Direct
3540473,125,0,35,155,120,35,35,Direct
3540573,450,145,35,185,150,35,35,Direct
3540609,225,45,20,125,105,20,20,Direct
3540650,225,25,35,195,160,35,35,Direct
3540807,175,20,35,160,125,35,35,Direct
3541016,125,0,60,190,130,60,60,Direct
3541143,150,0,10,15,5,10,10,Direct
3541252,125,0,65,210,145,65,65,Direct
3541250,400,135,100,285,185,100,100,Direct
3541352,175,5,25,95,70,25,25,Direct
3528482,100,0,5,10,5,5,5,Direct
3541645,225,25,35,285,250,35,35,Direct
3541952,200,30,50,270,220,50,50,Direct
3542086,175,5,35,135,100,35,35,Direct
3542288,225,45,50,215,165,50,50,Direct
3542322,125,0,35,200,165,35,35,Direct
3542581,100,0,20,140,120,20,20,Direct
3542679,325,75,35,150,115,35,35,Direct
3542688,425,170,35,270,235,35,35,Direct
3542945,150,0,35,140,105,35,35,Direct
3542979,125,0,35,155,120,35,35,Direct
3543081,200,25,35,160,125,35,35,Direct
3543281,275,90,51,201,150,51,51,Direct
3543288,200,10,35,150,115,35,35,Direct
3543481,225,35,50,205,155,50,50,Direct
3543517,100,0,50,200,150,50,50,Direct
3543715,125,0,35,180,145,35,35,Direct
3543758,175,0,35,150,115,35,35,Direct
3543851,125,0,20,50,30,20,20,Direct
3543924,125,0,50,265,215,50,50,Direct
3544194,50,0,35,150,115,35,35,Direct
3544024,475,190,50,250,200,50,50,Direct
3544417,200,25,25,55,30,25,25,Direct
3544453,175,10,25,60,35,25,25,Direct
3544494,175,10,25,90,65,25,25,Direct
3544558,125,0,35,140,105,35,35,Direct
3558463,100,0,35,175,140,35,35,Direct
3559285,100,0,35,225,190,35,35,Direct
3559335,225,45,50,375,325,50,50,Direct
3559535,325,95,50,265,215,50,50,Direct
3559542,125,0,23,83,60,23,23,Direct
3559549,125,0,35,275,240,35,35,Direct
3559585,100,0,50,265,215,50,50,Direct
3559835,175,10,20,180,160,20,20,Direct
3560814,100,0,50,265,215,50,50,Direct
3540615,350,95,20,195,175,20,20,Direct
3561314,50,0,35,185,150,35,35,Direct
3561421,125,0,35,225,190,35,35,Direct
3561471,175,0,50,225,175,50,50,Direct
3561357,300,75,35,150,115,35,35,Direct
3561857,100,0,35,130,95,35,35,Direct
3558549,125,0,50,225,175,50,50,Direct
3562950,150,0,35,120,85,35,35,Direct
3563000,225,35,50,270,220,50,50,Direct
3563036,125,0,35,175,140,35,35,Direct
3563043,250,60,50,210,160,50,50,Direct
3563229,350,105,50,215,165,50,50,Direct
3563293,200,20,35,170,135,35,35,Direct
3563436,200,15,20,160,140,20,20,Direct
3563622,100,0,35,225,190,35,35,Direct
3536871,275,75,35,160,125,35,35,Direct
3524546,100,0,35,285,250,35,35,Direct
3565265,275,60,50,275,225,50,50,Direct
3565465,200,15,50,225,175,50,50,Direct
3566244,300,90,50,365,315,50,50,Direct
3566437,150,0,20,170,150,20,20,Direct
3566537,100,0,50,245,195,50,50,Direct
3566580,100,0,25,80,55,25,25,Direct
3566394,100,0,35,150,115,35,35,Direct
3567037,250,50,35,125,90,35,35,Direct
3567473,50,0,20,50,30,20,20,Direct
3566973,225,45,75,365,290,75,75,Direct
3567623,175,5,35,185,150,35,35,Direct
3567823,75,0,20,50,30,20,20,Direct
3567966,125,0,35,170,135,35,35,Direct
3568016,300,90,35,185,150,35,35,Direct
3568416,275,70,50,275,225,50,50,Direct
3568566,200,30,35,255,220,35,35,Direct
3568909,200,15,20,55,35,20,20,Direct
3569059,275,60,35,185,150,35,35,Direct
3549968,300,90,50,245,195,50,50,Direct
3569938,175,10,35,180,145,35,35,Direct
3570188,325,105,55,300,245,55,55,Direct
3570381,225,45,50,270,220,50,50,Direct
3570524,175,5,50,225,175,50,50,Direct
3571317,175,20,50,290,240,50,50,Direct
3566644,300,85,35,215,180,35,35,Direct
3571960,275,70,35,155,120,35,35,Direct
3571917,100,0,20,85,65,20,20,Direct
3572353,200,25,20,75,55,20,20,Direct
3573589,250,65,75,350,275,75,75,Direct
3560765,200,20,35,220,185,35,35,Direct
3563292,175,5,50,230,180,50,50,Direct
3563759,75,0,20,75,55,20,20,Direct
3563841,375,130,50,230,180,50,50,Direct
3564109,250,55,35,125,90,35,35,Direct
3564963,175,15,35,155,120,35,35,Direct
3558194,175,5,35,195,160,35,35,Direct
3565214,125,0,35,260,225,35,35,Direct
3550805,275,55,35,120,85,35,35,Direct
3565849,225,45,35,155,120,35,35,Direct
3565899,175,10,35,160,125,35,35,Direct
3566031,175,10,35,135,100,35,35,Direct
3566214,200,30,35,180,145,35,35,Direct
3566232,125,0,35,150,115,35,35,Direct
3567150,225,45,50,225,175,50,50,Direct
3567436,500,195,35,260,225,35,35,Direct
3567768,200,20,50,220,170,50,50,Direct
3568053,125,0,50,200,150,50,50,Direct
3568086,125,0,50,275,225,50,50,Direct
3568121,125,0,35,125,90,35,35,Direct
3568371,175,10,50,245,195,50,50,Direct
3568354,175,0,35,180,145,35,35,Direct
3568439,275,65,50,270,220,50,50,Direct
3568486,75,0,35,120,85,35,35,Direct
3568789,100,0,35,280,245,35,35,Direct
3568907,325,105,35,185,150,35,35,Direct
3568954,200,20,20,140,120,20,20,Direct
3569525,450,140,50,220,170,50,50,Direct
3569490,175,10,35,295,260,35,35,Direct
3570176,300,75,35,220,185,35,35,Direct
3569558,200,35,75,300,225,75,75,Direct
3570512,200,30,35,140,105,35,35,Direct
3570525,200,20,20,110,90,20,20,Direct
3571030,175,20,35,170,135,35,35,Direct
3571061,75,0,35,155,120,35,35,Direct
3571247,275,55,35,190,155,35,35,Direct
3571865,175,15,20,65,45,20,20,Direct
3572784,175,5,50,245,195,50,50,Direct
3573784,275,85,50,350,300,50,50,Direct
3545096,175,5,35,190,155,35,35,Direct
3499695,100,0,35,175,140,35,35,Direct
3545387,175,10,35,150,115,35,35,Direct
3545396,100,0,35,150,115,35,35,Direct
3545487,175,10,35,150,115,35,35,Direct
3545489,150,0,20,180,160,20,20,Direct
3545596,0,0,20,115,95,20,20,Direct
3545889,200,20,35,165,130,35,35,Direct
3545987,325,90,35,290,255,35,35,Direct
3546332,50,0,35,205,170,35,35,Direct
3546423,200,30,40,220,180,40,40,Direct
3546525,250,50,20,170,150,20,20,Direct
3546630,125,0,25,85,60,25,25,Direct
3546789,50,0,60,175,115,60,60,Direct
3547059,100,0,35,125,90,35,35,Direct
3547159,125,0,35,155,120,35,35,Direct
3547225,250,40,50,325,275,50,50,Direct
3547359,125,0,20,95,75,20,20,Direct
3547361,300,85,35,185,150,35,35,Direct
3547566,250,45,35,190,155,35,35,Direct
3547702,100,0,50,270,220,50,50,Direct
3548597,425,140,50,230,180,50,50,Direct
3548938,150,0,50,220,170,50,50,Direct
3548997,300,70,50,200,150,50,50,Direct
3518479,300,95,35,265,230,35,35,Direct
3541109,250,45,20,120,100,20,20,Direct
3549231,300,100,40,275,235,40,40,Direct
3549533,350,115,35,290,255,35,35,Direct
3549574,0,0,35,260,225,35,35,Direct
3549833,100,0,50,220,170,50,50,Direct
3549940,350,100,35,190,155,35,35,Direct
3550076,325,95,50,200,150,50,50,Direct
3550074,125,0,35,185,150,35,35,Direct
3550110,50,0,35,255,220,35,35,Direct
3550276,175,15,60,160,100,60,60,Direct
3550576,575,265,55,460,405,55,55,Direct
3550710,250,50,40,275,235,40,40,Direct
3551176,300,70,35,190,155,35,35,Direct
3551569,200,30,35,155,120,35,35,Direct
3551805,150,0,40,230,190,40,40,Direct
3551846,150,5,35,190,155,35,35,Direct
3551939,200,20,35,150,115,35,35,Direct
3552348,150,5,35,140,105,35,35,Direct
3552439,75,0,35,115,80,35,35,Direct
3530713,375,170,20,195,175,20,20,Direct
3552675,475,165,35,295,260,35,35,Direct
3552748,75,0,35,255,220,35,35,Direct
3552984,200,10,50,210,160,50,50,Direct
3553675,300,85,55,405,350,55,55,Direct
3553820,175,10,20,130,110,20,20,Direct
3553984,275,85,50,375,325,50,50,Direct
3554184,200,30,25,90,65,25,25,Direct
3554320,200,40,20,50,30,20,20,Direct
3452033,200,35,35,270,235,35,35,Direct
3554647,100,0,35,190,155,35,35,Direct
3554711,250,50,50,275,225,50,50,Direct
3554956,175,0,35,160,125,35,35,Direct
3555590,125,0,35,150,115,35,35,Direct
3555647,200,25,20,145,125,20,20,Direct
3555792,75,0,20,45,25,20,20,Direct
3556349,25,0,35,155,120,35,35,Direct
3557028,175,10,35,170,135,35,35,Direct
3557092,150,0,35,175,140,35,35,Direct
3557126,125,0,50,205,155,50,50,Direct
3557285,275,85,35,185,150,35,35,Direct
3557321,125,0,35,190,155,35,35,Direct
3557728,25,0,50,375,325,50,50,Direct
3557721,100,0,35,175,140,35,35,Direct
3557855,250,50,50,255,205,50,50,Direct
3554911,250,40,35,170,135,35,35,Direct
3558021,150,0,50,250,200,50,50,Direct
3558321,150,0,50,210,160,50,50,Direct
3558664,100,0,20,75,55,20,20,Direct
3558857,175,5,50,275,225,50,50,Direct
3559064,100,0,50,205,155,50,50,Direct
3559191,375,120,50,285,235,50,50,Direct
3494681,200,30,35,120,85,35,35,Direct
3559727,300,90,35,190,155,35,35,Direct
3559791,250,25,20,135,115,20,20,Direct
3559836,100,0,35,165,130,35,35,Direct
3534564,250,45,35,190,155,35,35,Direct
3560906,250,40,35,290,255,35,35,Direct
3561365,175,10,35,185,150,35,35,Direct
3561429,175,10,35,150,115,35,35,Direct
3561772,325,90,35,160,125,35,35,Direct
3562399,25,0,35,160,125,35,35,Direct
3562408,225,35,20,130,110,20,20,Direct
3546689,100,0,35,150,115,35,35,Direct
3562935,100,0,40,240,200,40,40,Direct
3563042,100,0,35,190,155,35,35,Direct
3563078,200,25,50,275,225,50,50,Direct
3563671,75,0,35,155,120,35,35,Direct
3563878,50,0,35,160,125,35,35,Direct
3564078,175,5,35,195,160,35,35,Direct
3559057,250,60,35,230,195,35,35,Direct
3551946,125,0,35,185,150,35,35,Direct
3565014,350,90,35,165,130,35,35,Direct
3565114,175,15,50,210,160,50,50,Direct
3565950,250,65,50,205,155,50,50,Direct
3566588,175,0,20,75,55,20,20,Direct
3566652,300,80,35,160,125,35,35,Direct
3567715,200,35,20,140,120,20,20,Direct
3567858,150,0,35,245,210,35,35,Direct
3568215,100,0,20,170,150,20,20,Direct
3568251,175,5,50,275,225,50,50,Direct
3568658,100,0,20,140,120,20,20,Direct
3567817,250,75,50,235,185,50,50,Direct
3569453,100,0,35,190,155,35,35,Direct
3569496,175,0,50,240,190,50,50,Direct
3569894,200,25,20,85,65,20,20,Direct
3570189,75,0,35,180,145,35,35,Direct
3558698,100,0,35,255,220,35,35,Direct
3571223,125,0,35,230,195,35,35,Direct
3571725,250,45,50,225,175,50,50,Direct
3571902,100,0,50,275,225,50,50,Direct
3572159,175,0,35,125,90,35,35,Direct
3575212,250,50,50,250,200,50,50,Direct
3423641,125,0,35,140,105,35,35,Direct
3425028,125,0,50,300,250,50,50,Direct
3373704,75,0,20,80,60,20,20,Direct
3421884,225,15,35,260,225,35,35,Direct
3426849,125,0,35,250,215,35,35,Direct
3436259,75,0,25,55,30,25,25,Direct
3440890,50,0,35,225,190,35,35,Direct
3440603,150,0,35,240,205,35,35,Direct
3443447,100,0,35,150,115,35,35,Direct
3444112,200,0,50,270,220,50,50,Direct
3444983,400,115,60,195,135,60,60,Direct
3446070,175,0,35,270,235,35,35,Direct
3446405,200,0,75,370,295,75,75,Direct
3446806,125,0,60,100,40,60,60,Direct
3447792,200,0,35,180,145,35,35,Direct
3448577,250,0,35,245,210,35,35,Direct
3449964,425,145,50,220,170,50,50,Direct
3450163,125,0,50,225,175,50,50,Direct
3450449,150,0,60,140,80,60,60,Direct
3434787,175,0,50,235,185,50,50,Direct
3451585,75,0,35,245,210,35,35,Direct
3451686,75,0,35,185,150,35,35,Direct
3451935,225,15,35,290,255,35,35,Direct
3452000,125,0,35,155,120,35,35,Direct
3452536,275,0,25,80,55,25,25,Direct
3453808,250,40,35,135,100,35,35,Direct
3453958,125,0,20,80,60,20,20,Direct
3454994,150,0,35,165,130,35,35,Direct
3455179,100,0,35,235,200,35,35,Direct
3455293,175,0,35,250,215,35,35,Direct
3455394,100,0,35,155,120,35,35,Direct
3455980,250,0,0,5,5,0,0,Direct
3456530,75,0,35,180,145,35,35,Direct
3457402,75,0,35,150,115,35,35,Direct
3457802,150,0,35,190,155,35,35,Direct
3458287,150,0,35,180,145,35,35,Direct
3458387,75,0,35,180,145,35,35,Direct
3444733,325,20,35,105,70,35,35,Direct
3452722,200,0,35,135,100,35,35,Direct
3451986,200,0,35,195,160,35,35,Direct
3369123,250,0,20,95,75,20,20,Direct
3458987,1325,795,500,1515,1015,500,500,Direct
3459674,100,0,35,150,115,35,35,Direct
3459874,75,0,20,80,60,20,20,Direct
3459924,200,0,60,140,80,60,60,Direct
3459959,2900,2080,700,2805,2105,700,700,Direct
3460124,300,45,50,275,225,50,50,Direct
3460474,200,0,50,270,220,50,50,Direct
3460559,150,0,35,190,155,35,35,Direct
3460724,300,45,50,200,150,50,50,Direct
3450614,175,0,35,170,135,35,35,Direct
3461160,75,0,35,125,90,35,35,Direct
3461259,75,0,10,15,5,10,10,Direct
3461310,150,0,20,85,65,20,20,Direct
3461645,250,0,35,150,115,35,35,Direct
3462282,850,470,140,620,480,140,140,Direct
3462496,250,0,35,115,80,35,35,Direct
3462831,250,0,35,145,110,35,35,Direct
3463017,150,0,20,190,170,20,20,Direct
3463317,75,0,35,150,115,35,35,Direct
3463517,450,140,50,220,170,50,50,Direct
3463817,150,0,20,140,120,20,20,Direct
3463968,250,0,35,215,180,35,35,Direct
3464103,225,0,35,170,135,35,35,Direct
3464268,450,170,35,210,175,35,35,Direct
3464504,100,0,20,90,70,20,20,Direct
3464503,375,95,75,350,275,75,75,Direct
3459738,100,0,35,155,120,35,35,Direct
3465004,225,0,35,125,90,35,35,Direct
3465340,325,45,35,135,100,35,35,Direct
3465454,200,0,20,80,60,20,20,Direct
3465639,200,0,50,250,200,50,50,Direct
3466139,250,0,50,230,180,50,50,Direct
3466961,150,0,50,225,175,50,50,Direct
3467026,525,220,55,400,345,55,55,Direct
3466225,75,0,50,200,150,50,50,Direct
3467161,125,0,35,240,205,35,35,Direct
3467225,225,0,50,255,205,50,50,Direct
3467526,150,0,35,135,100,35,35,Direct
3467512,125,0,50,250,200,50,50,Direct
3467997,150,0,50,250,200,50,50,Direct
3468211,400,175,50,350,300,50,50,Direct
3468362,125,0,35,130,95,35,35,Direct
3459088,275,0,35,145,110,35,35,Direct
3468933,275,0,50,200,150,50,50,Direct
3468998,200,0,35,100,65,35,35,Direct
3469133,150,0,35,155,120,35,35,Direct
3469184,100,0,50,220,170,50,50,Direct
3469334,250,40,35,125,90,35,35,Direct
3469383,275,0,35,135,100,35,35,Direct
3469434,400,95,50,255,205,50,50,Direct
3435773,225,0,75,350,275,75,75,Direct
3469583,100,0,35,180,145,35,35,Direct
3469769,275,0,60,175,115,60,60,Direct
3467712,150,0,50,255,205,50,50,Direct
3469919,100,0,20,75,55,20,20,Direct
3470034,700,365,40,1240,1200,40,40,Direct
3470069,225,0,35,260,225,35,35,Direct
3470484,250,0,35,135,100,35,35,Direct
3470519,225,15,20,175,155,20,20,Direct
3465739,125,0,35,165,130,35,35,Direct
3471420,75,0,20,160,140,20,20,Direct
3471691,100,0,35,165,130,35,35,Direct
3471856,200,35,25,75,50,25,25,Direct
3472142,175,15,20,170,150,20,20,Direct
3472291,225,35,20,170,150,20,20,Direct
3472306,25,0,35,175,140,35,35,Direct
3472506,50,0,60,145,85,60,60,Direct
3472542,125,0,35,125,90,35,35,Direct
3473042,200,25,50,275,225,50,50,Direct
3473328,250,55,19,89,70,19,19,Direct
3473378,125,0,35,170,135,35,35,Direct
3473563,425,115,35,190,155,35,35,Direct
3473628,175,15,35,175,140,35,35,Direct
3473828,150,0,20,160,140,20,20,Direct
3474214,250,65,50,205,155,50,50,Direct
3474213,200,30,20,75,55,20,20,Direct
3474263,100,0,35,170,135,35,35,Direct
3474513,175,5,50,285,235,50,50,Direct
3474563,150,0,35,155,120,35,35,Direct
3474764,350,115,20,145,125,20,20,Direct
3474864,175,10,35,100,65,35,35,Direct
3474963,100,0,35,150,115,35,35,Direct
3475014,150,0,20,160,140,20,20,Direct
3474999,225,35,35,170,135,35,35,Direct
3475349,200,40,35,135,100,35,35,Direct
3475549,175,5,35,175,140,35,35,Direct
3475599,275,80,75,350,275,75,75,Direct
3475649,225,25,35,160,125,35,35,Direct
3475785,125,0,35,145,110,35,35,Direct
3475849,200,25,20,110,90,20,20,Direct
3475949,200,25,35,145,110,35,35,Direct
3475999,200,25,35,190,155,35,35,Direct
3476085,175,5,35,280,245,35,35,Direct
3476235,250,70,50,295,245,50,50,Direct
3476285,125,0,20,80,60,20,20,Direct
3469283,175,5,25,75,50,25,25,Direct
3476635,175,5,50,210,160,50,50,Direct
3476686,75,0,20,65,45,20,20,Direct
3476785,150,0,35,175,140,35,35,Direct
3476871,300,115,50,275,225,50,50,Direct
3476936,100,0,35,250,215,35,35,Direct
3477336,300,55,50,255,205,50,50,Direct
3477421,75,0,35,160,125,35,35,Direct
3477772,325,105,50,325,275,50,50,Direct
3478022,100,0,25,65,40,25,25,Direct
3478107,50,0,20,80,60,20,20,Direct
3478108,125,0,20,140,120,20,20,Direct
3478257,200,20,100,250,150,100,100,Direct
3478307,200,30,35,150,115,35,35,Direct
3478693,175,10,20,45,25,20,20,Direct
3478743,175,10,35,180,145,35,35,Direct
3478957,75,0,50,200,150,50,50,Direct
3475164,175,5,35,180,145,35,35,Direct
3458652,175,10,50,250,200,50,50,Direct
3479194,100,0,15,85,70,15,15,Direct
3479444,125,0,50,205,155,50,50,Direct
3479493,50,0,35,190,155,35,35,Direct
3479544,75,0,20,140,120,20,20,Direct
3479629,275,55,35,180,145,35,35,Direct
3479644,175,10,50,200,150,50,50,Direct
3478457,200,15,50,250,200,50,50,Direct
3479844,250,45,60,150,90,60,60,Direct
3479929,225,40,50,225,175,50,50,Direct
3480630,175,5,50,230,180,50,50,Direct
3480865,50,0,20,170,150,20,20,Direct
3481351,75,0,35,180,145,35,35,Direct
3481451,200,35,60,195,135,60,60,Direct
3481651,475,190,50,275,225,50,50,Direct
3481865,375,130,35,245,210,35,35,Direct
3482002,225,30,60,150,90,60,60,Direct
3482151,100,0,35,125,90,35,35,Direct
3482252,175,5,35,155,120,35,35,Direct
3482452,200,20,35,200,165,35,35,Direct
3478608,125,0,35,125,90,35,35,Direct
3480280,100,0,35,190,155,35,35,Direct
3450864,400,150,100,310,210,100,100,Direct
3483538,175,5,35,175,140,35,35,Direct
3483587,200,25,35,190,155,35,35,Direct
3483737,350,120,50,250,200,50,50,Direct
3484038,150,0,35,230,195,35,35,Direct
3484323,275,60,50,250,200,50,50,Direct
3484374,375,155,110,405,295,110,110,Direct
3484373,175,10,20,180,160,20,20,Direct
3484473,100,0,35,140,105,35,35,Direct
3484509,25,0,50,235,185,50,50,Direct
3484759,1200,640,400,1045,645,400,400,Direct
3485210,225,55,20,80,60,20,20,Direct
3485345,75,0,20,65,45,20,20,Direct
3485696,125,0,50,235,185,50,50,Direct
3485745,200,20,35,100,65,35,35,Direct
3485810,150,0,20,35,15,20,20,Direct
3486331,200,0,35,185,150,35,35,Direct
3486632,100,0,20,50,30,20,20,Direct
3468547,250,50,35,140,105,35,35,Direct
3485746,100,0,35,150,115,35,35,Direct
3486781,300,75,50,295,245,50,50,Direct
3486946,225,50,20,160,140,20,20,Direct
3487082,125,0,60,190,130,60,60,Direct
3487217,200,35,50,200,150,50,50,Direct
3487267,225,55,35,125,90,35,35,Direct
3487417,125,0,50,220,170,50,50,Direct
3487431,375,150,110,425,315,110,110,Direct
3487532,200,30,35,160,125,35,35,Direct
3487681,175,10,35,175,140,35,35,Direct
3487868,75,0,20,135,115,20,20,Direct
3488017,200,30,35,100,65,35,35,Direct
3488167,50,0,35,165,130,35,35,Direct
3488218,25,0,60,120,60,60,60,Direct
3488303,250,40,50,230,180,50,50,Direct
3486645,100,0,50,375,325,50,50,Direct
3488704,125,0,35,135,100,35,35,Direct
3488753,50,0,20,95,75,20,20,Direct
3488918,175,5,35,195,160,35,35,Direct
3489103,100,0,25,90,65,25,25,Direct
3484524,150,0,35,275,240,35,35,Direct
3489339,250,65,75,345,270,75,75,Direct
3489603,400,145,20,170,150,20,20,Direct
3489640,175,15,35,140,105,35,35,Direct
3489740,100,0,35,130,95,35,35,Direct
3489989,225,40,35,105,70,35,35,Direct
3432366,325,115,20,170,150,20,20,Direct
3472777,200,20,35,170,135,35,35,Direct
3490289,250,40,35,125,90,35,35,Direct
3490525,75,0,35,130,95,35,35,Direct
3490590,125,0,35,170,135,35,35,Direct
3490575,175,5,35,170,135,35,35,Direct
3490876,100,0,35,145,110,35,35,Direct
3489589,100,0,20,170,150,20,20,Direct
3489554,250,105,50,200,150,50,50,Direct
3491125,125,0,35,100,65,35,35,Direct
3491176,125,0,50,275,225,50,50,Direct
3491211,275,40,50,235,185,50,50,Direct
3491261,225,35,35,180,145,35,35,Direct
3491361,175,10,50,250,200,50,50,Direct
3491376,250,40,20,95,75,20,20,Direct
3491425,50,0,35,150,115,35,35,Direct
3491626,275,90,60,195,135,60,60,Direct
3491661,150,0,35,180,145,35,35,Direct
3491776,300,85,50,250,200,50,50,Direct
3491811,125,0,35,180,145,35,35,Direct
3491861,100,0,35,150,115,35,35,Direct
3492012,200,30,35,185,150,35,35,Direct
3492247,350,125,75,365,290,75,75,Direct
3492448,75,0,35,140,105,35,35,Direct
3492447,75,0,20,140,120,20,20,Direct
3491676,200,15,50,220,170,50,50,Direct
3492561,200,50,35,170,135,35,35,Direct
3492647,200,15,35,245,210,35,35,Direct
3492748,200,10,36,161,125,36,36,Direct
3492812,275,75,35,180,145,35,35,Direct
3492797,175,20,50,275,225,50,50,Direct
3492848,75,0,35,175,140,35,35,Direct
3493097,425,120,50,200,150,50,50,Direct
3493348,125,0,20,160,140,20,20,Direct
3493633,275,75,35,230,195,35,35,Direct
3493547,175,5,60,125,65,60,60,Direct
3493783,525,240,125,500,375,125,125,Direct
3493798,250,45,50,230,180,50,50,Direct
3493848,225,15,40,220,180,40,40,Direct
3493933,75,0,35,130,95,35,35,Direct
3494019,175,15,50,250,200,50,50,Direct
3494083,75,0,35,155,120,35,35,Direct
3494334,150,5,20,180,160,20,20,Direct
3494234,125,0,20,170,150,20,20,Direct
3494470,325,120,55,425,370,55,55,Direct
3494669,100,0,20,80,60,20,20,Direct
3494719,275,85,35,240,205,35,35,Direct
3494769,175,10,35,185,150,35,35,Direct
3495070,275,50,50,265,215,50,50,Direct
3495020,100,0,20,95,75,20,20,Direct
3490890,50,0,35,160,125,35,35,Direct
3492548,175,0,40,200,160,40,40,Direct
3493083,50,0,35,150,115,35,35,Direct
3490675,200,20,20,160,140,20,20,Direct
3495755,125,0,35,150,115,35,35,Direct
3495856,75,0,35,280,245,35,35,Direct
3496106,375,150,50,275,225,50,50,Direct
3496155,100,0,50,325,275,50,50,Direct
3496306,275,70,50,225,175,50,50,Direct
3496341,175,5,20,125,105,20,20,Direct
3496392,125,0,20,80,60,20,20,Direct
3496405,50,0,50,240,190,50,50,Direct
3496455,275,50,35,185,150,35,35,Direct
3496506,300,80,50,215,165,50,50,Direct
3496556,100,0,20,135,115,20,20,Direct
3496791,250,65,50,200,150,50,50,Direct
3494684,425,115,35,270,235,35,35,Direct
3497127,75,0,20,100,80,20,20,Direct
3497527,325,120,35,170,135,35,35,Direct
3497828,125,0,20,40,20,20,20,Direct
3498228,125,0,35,125,90,35,35,Direct
3498313,175,0,35,190,155,35,35,Direct
3498428,100,0,35,180,145,35,35,Direct
3498563,125,0,35,115,80,35,35,Direct
3498613,150,0,50,230,180,50,50,Direct
3498914,75,0,20,95,75,20,20,Direct
3498913,300,85,50,205,155,50,50,Direct
3498964,175,10,50,250,200,50,50,Direct
3499099,175,5,35,190,155,35,35,Direct
3499364,150,0,35,185,150,35,35,Direct
3499400,175,15,25,90,65,25,25,Direct
3499614,50,0,35,175,140,35,35,Direct
3499700,175,5,20,140,120,20,20,Direct
3478657,325,100,110,465,355,110,110,Direct
3499999,125,0,35,190,155,35,35,Direct
3499985,200,25,35,145,110,35,35,Direct
3500436,125,0,35,125,90,35,35,Direct
3500435,300,95,35,260,225,35,35,Direct
3500686,100,0,35,110,75,35,35,Direct
3500821,175,15,35,190,155,35,35,Direct
3501135,125,0,18,98,80,18,18,Direct
3501236,200,15,35,190,155,35,35,Direct
3501235,250,50,50,200,150,50,50,Direct
3501336,225,30,35,160,125,35,35,Direct
3501807,50,0,35,150,115,35,35,Direct
3501822,125,0,35,110,75,35,35,Direct
3501872,200,10,35,190,155,35,35,Direct
3502071,300,75,50,230,180,50,50,Direct
3502171,225,45,50,375,325,50,50,Direct
3502272,75,0,50,205,155,50,50,Direct
3502208,75,0,35,135,100,35,35,Direct
3502321,200,30,20,75,55,20,20,Direct
3503043,200,30,35,190,155,35,35,Direct
3503243,200,20,35,150,115,35,35,Direct
3503244,25,0,35,145,110,35,35,Direct
3502993,175,15,35,150,115,35,35,Direct
3500335,325,90,50,235,185,50,50,Direct
3503879,75,0,20,170,150,20,20,Direct
3503943,125,0,40,200,160,40,40,Direct
3504280,200,10,35,145,110,35,35,Direct
3504829,100,0,50,210,160,50,50,Direct
3504980,375,120,20,190,170,20,20,Direct
3505165,100,0,50,325,275,50,50,Direct
3505230,50,0,35,180,145,35,35,Direct
3505265,225,25,35,175,140,35,35,Direct
3505380,75,0,35,125,90,35,35,Direct
3505466,175,10,35,125,90,35,35,Direct
3502943,175,10,35,150,115,35,35,Direct
3506015,100,0,40,225,185,40,40,Direct
3506152,275,60,35,245,210,35,35,Direct
3506352,375,150,50,250,200,50,50,Direct
3499213,100,0,50,230,180,50,50,Direct
3506937,200,50,75,330,255,75,75,Direct
3506987,50,0,35,115,80,35,35,Direct
3507088,125,0,50,250,200,50,50,Direct
3507152,225,35,35,270,235,35,35,Direct
3507188,150,0,35,155,120,35,35,Direct
3494034,125,0,50,270,220,50,50,Direct
3503994,25,0,35,245,210,35,35,Direct
3507673,200,10,50,235,185,50,50,Direct
3507973,200,30,35,225,190,35,35,Direct
3508074,125,0,20,140,120,20,20,Direct
3508273,175,15,50,205,155,50,50,Direct
3508823,275,75,50,235,185,50,50,Direct
3508909,125,0,20,160,140,20,20,Direct
3508974,225,30,20,135,115,20,20,Direct
3509024,200,15,50,265,215,50,50,Direct
3509124,150,0,60,100,40,60,60,Direct
3509224,150,0,35,190,155,35,35,Direct
3507887,175,10,50,270,220,50,50,Direct
3509945,200,30,35,175,140,35,35,Direct
3510046,75,0,35,180,145,35,35,Direct
3508924,250,50,50,350,300,50,50,Direct
3510145,250,50,25,80,55,25,25,Direct
3510246,150,0,50,225,175,50,50,Direct
3510296,200,35,35,125,90,35,35,Direct
3510346,225,45,50,310,260,50,50,Direct
3510845,300,70,35,190,155,35,35,Direct
3501471,125,0,35,150,115,35,35,Direct
3482501,450,170,75,390,315,75,75,Direct
3511182,300,70,50,240,190,50,50,Direct
3511181,150,0,20,170,150,20,20,Direct
3511332,200,30,50,220,170,50,50,Direct
3507187,50,0,20,185,165,20,20,Direct
3511832,300,75,35,185,150,35,35,Direct
3511931,200,10,50,200,150,50,50,Direct
3512067,200,20,35,265,230,35,35,Direct
3512567,125,0,50,220,170,50,50,Direct
3512818,175,10,60,125,65,60,60,Direct
3512918,225,35,50,205,155,50,50,Direct
3512868,225,50,20,140,120,20,20,Direct
3513103,75,0,20,140,120,20,20,Direct
3513104,400,135,50,285,235,50,50,Direct
3513504,225,45,50,260,210,50,50,Direct
3513603,50,0,35,150,115,35,35,Direct
3513653,175,0,50,205,155,50,50,Direct
3513990,225,60,40,205,165,40,40,Direct
3514154,100,0,35,115,80,35,35,Direct
3514239,200,40,35,175,140,35,35,Direct
3514240,175,10,20,80,60,20,20,Direct
3514290,200,25,20,180,160,20,20,Direct
3514354,200,30,60,135,75,60,60,Direct
3514390,175,0,20,145,125,20,20,Direct
3514539,225,60,35,155,120,35,35,Direct
3514926,150,0,35,150,115,35,35,Direct
3515040,175,10,50,210,160,50,50,Direct
3497792,500,195,35,260,225,35,35,Direct
3515190,175,10,35,120,85,35,35,Direct
3515275,275,80,50,270,220,50,50,Direct
3505901,150,0,35,150,115,35,35,Direct
3515626,150,5,35,170,135,35,35,Direct
3515726,125,0,40,210,170,40,40,Direct
3515862,200,15,35,175,140,35,35,Direct
3515912,150,0,35,165,130,35,35,Direct
3516076,150,5,20,80,60,20,20,Direct
3516311,225,45,35,260,225,35,35,Direct
3516411,125,0,20,180,160,20,20,Direct
3516412,225,35,35,175,140,35,35,Direct
3516462,175,15,50,260,210,50,50,Direct
3516512,200,20,50,260,210,50,50,Direct
3516561,125,0,20,95,75,20,20,Direct
3516611,200,25,35,180,145,35,35,Direct
3516747,225,35,35,225,190,35,35,Direct
3516761,125,0,35,155,120,35,35,Direct
3516662,50,0,35,140,105,35,35,Direct
3516962,200,35,35,260,225,35,35,Direct
3516998,75,0,25,80,55,25,25,Direct
3517198,175,15,50,375,325,50,50,Direct
3517347,100,0,25,65,40,25,25,Direct
3517398,225,45,35,225,190,35,35,Direct
3517733,100,0,35,105,70,35,35,Direct
3517948,150,5,50,205,155,50,50,Direct
3518033,325,90,20,190,170,20,20,Direct
3518048,100,0,35,225,190,35,35,Direct
3518098,75,0,35,155,120,35,35,Direct
3518333,275,55,50,220,170,50,50,Direct
3518469,75,0,35,150,115,35,35,Direct
3518884,325,85,50,275,225,50,50,Direct
3519020,175,10,20,85,65,20,20,Direct
3519655,225,30,50,210,160,50,50,Direct
3519720,175,10,20,140,120,20,20,Direct
3519770,100,0,20,85,65,20,20,Direct
3519905,225,25,50,375,325,50,50,Direct
3520355,425,115,50,250,200,50,50,Direct
3520406,375,150,20,180,160,20,20,Direct
3520206,200,30,20,95,75,20,20,Direct
3517383,125,0,25,65,40,25,25,Direct
3520741,200,30,35,275,240,35,35,Direct
3520742,200,35,20,170,150,20,20,Direct
3520842,200,20,50,260,210,50,50,Direct
3520942,225,45,35,185,150,35,35,Direct
3520991,75,0,20,85,65,20,20,Direct
3521327,175,15,35,115,80,35,35,Direct
3521391,75,0,20,130,110,20,20,Direct
3521677,275,120,50,325,275,50,50,Direct
3521678,175,5,20,75,55,20,20,Direct
3521728,125,0,35,260,225,35,35,Direct
3522128,75,0,20,45,25,20,20,Direct
3522127,225,40,35,190,155,35,35,Direct
3522328,625,320,65,540,475,65,65,Direct
3522428,200,25,35,250,215,35,35,Direct
3522577,525,240,75,345,270,75,75,Direct
3522914,100,0,50,250,200,50,50,Direct
3522928,250,55,25,90,65,25,25,Direct
3523164,250,50,20,110,90,20,20,Direct
3523713,325,95,50,275,225,50,50,Direct
3523864,225,55,60,160,100,60,60,Direct
3523899,75,0,50,210,160,50,50,Direct
3524185,500,195,75,300,225,75,75,Direct
3524199,150,0,50,325,275,50,50,Direct
3524285,175,20,35,170,135,35,35,Direct
3524399,150,0,50,275,225,50,50,Direct
3524836,100,0,25,80,55,25,25,Direct
3525421,75,0,50,205,155,50,50,Direct
3525771,225,40,20,170,150,20,20,Direct
3526071,275,65,35,250,215,35,35,Direct
3526107,250,40,35,185,150,35,35,Direct
3526121,500,195,35,260,225,35,35,Direct
3526322,450,170,50,270,220,50,50,Direct
3526521,200,30,75,385,310,75,75,Direct
3526508,350,140,50,250,200,50,50,Direct
3526558,275,80,50,205,155,50,50,Direct
3526608,200,30,60,195,135,60,60,Direct
3526622,175,15,40,275,235,40,40,Direct
3526872,100,0,20,160,140,20,20,Direct
3525672,200,30,50,220,170,50,50,Direct
3527358,175,10,35,170,135,35,35,Direct
3527543,150,0,50,240,190,50,50,Direct
3527557,275,75,50,275,225,50,50,Direct
3527744,125,0,50,230,180,50,50,Direct
3527743,175,10,50,220,170,50,50,Direct
3510645,100,0,35,140,105,35,35,Direct
3528094,125,0,50,220,170,50,50,Direct
3521691,150,0,35,150,115,35,35,Direct
3528294,300,75,35,135,100,35,35,Direct
3528480,75,0,35,150,115,35,35,Direct
3528429,325,135,35,250,215,35,35,Direct
3524835,575,255,50,375,325,50,50,Direct
3529516,50,0,75,305,230,75,75,Direct
3530001,175,20,35,150,115,35,35,Direct
3530065,200,20,35,160,125,35,35,Direct
3530101,75,0,50,275,225,50,50,Direct
3530651,300,90,60,195,135,60,60,Direct
3530716,200,40,35,190,155,35,35,Direct
3531302,125,0,35,105,70,35,35,Direct
3531337,75,0,35,135,100,35,35,Direct
3531437,100,0,20,80,60,20,20,Direct
3531737,225,35,75,300,225,75,75,Direct
3510345,225,35,35,160,125,35,35,Direct
3532123,250,50,50,205,155,50,50,Direct
3532223,100,0,25,85,60,25,25,Direct
3532338,175,15,35,165,130,35,35,Direct
3532437,200,30,50,390,340,50,50,Direct
3533423,75,0,35,145,110,35,35,Direct
3533624,75,0,35,155,120,35,35,Direct
3533959,175,15,20,140,120,20,20,Direct
3534195,125,0,35,145,110,35,35,Direct
3534309,250,55,35,175,140,35,35,Direct
3534359,575,280,110,450,340,110,110,Direct
3534409,100,0,20,140,120,20,20,Direct
3534460,50,0,35,250,215,35,35,Direct
3534696,225,60,35,200,165,35,35,Direct
3534745,200,15,20,160,140,20,20,Direct
3535046,175,15,20,135,115,20,20,Direct
3535096,125,0,20,140,120,20,20,Direct
3532374,200,20,35,195,160,35,35,Direct
3535832,125,0,35,195,160,35,35,Direct
3535932,75,0,50,275,225,50,50,Direct
3536232,200,25,20,80,60,20,20,Direct
3536268,100,0,35,150,115,35,35,Direct
3536331,350,135,75,300,225,75,75,Direct
3536317,150,0,35,200,165,35,35,Direct
3536468,175,15,20,125,105,20,20,Direct
3536682,250,65,75,325,250,75,75,Direct
3536717,75,0,50,200,150,50,50,Direct
3537053,200,35,20,125,105,20,20,Direct
3538003,225,45,35,210,175,35,35,Direct
3538004,400,150,50,230,180,50,50,Direct
3538154,325,85,35,150,115,35,35,Direct
3533860,75,0,35,185,150,35,35,Direct
3527607,175,0,35,150,115,35,35,Direct
3538540,250,55,75,350,275,75,75,Direct
3538690,425,120,220,460,240,220,220,Direct
3539125,100,0,50,200,150,50,50,Direct
3539239,175,15,35,155,120,35,35,Direct
3539290,250,50,35,190,155,35,35,Direct
3539490,200,35,50,260,210,50,50,Direct
3539625,75,0,20,140,120,20,20,Direct
3539976,100,0,35,100,65,35,35,Direct
3540061,100,0,35,210,175,35,35,Direct
3536082,150,5,35,220,185,35,35,Direct
3540212,200,30,35,290,255,35,35,Direct
3540225,100,0,35,135,100,35,35,Direct
3536132,225,30,40,220,180,40,40,Direct
3532724,250,25,20,180,160,20,20,Direct
3533810,150,0,20,90,70,20,20,Direct
3540411,275,65,35,230,195,35,35,Direct
3540747,100,0,35,190,155,35,35,Direct
3540811,100,0,50,225,175,50,50,Direct
3540911,75,0,50,220,170,50,50,Direct
3540712,175,10,35,165,130,35,35,Direct
3541247,450,140,35,185,150,35,35,Direct
3541262,150,0,35,185,150,35,35,Direct
3541312,225,30,35,140,105,35,35,Direct
3535781,75,0,20,25,5,20,20,Direct
3541347,175,0,35,150,115,35,35,Direct
3541447,50,0,50,220,170,50,50,Direct
3541733,100,0,35,225,190,35,35,Direct
3541833,50,0,35,125,90,35,35,Direct
3541847,175,20,50,200,150,50,50,Direct
3543083,225,45,35,210,175,35,35,Direct
3543134,75,0,35,225,190,35,35,Direct
3543170,200,30,50,295,245,50,50,Direct
3543269,225,35,60,120,60,60,60,Direct
3543655,175,5,35,150,115,35,35,Direct
3544270,75,0,35,150,115,35,35,Direct
3544406,325,105,50,205,155,50,50,Direct
3540376,125,0,20,140,120,20,20,Direct
3544705,200,25,20,160,140,20,20,Direct
3544841,25,0,20,55,35,20,20,Direct
3544456,250,60,35,140,105,35,35,Direct
3545191,75,0,50,220,170,50,50,Direct
3545356,225,45,75,310,235,75,75,Direct
3545541,75,0,20,120,100,20,20,Direct
3545542,225,30,35,135,100,35,35,Direct
3545692,50,0,35,255,220,35,35,Direct
3545791,200,15,35,275,240,35,35,Direct
3545877,200,15,35,105,70,35,35,Direct
3546092,100,0,50,230,180,50,50,Direct
3546563,175,15,60,175,115,60,60,Direct
3546577,200,25,20,95,75,20,20,Direct
3532188,100,0,35,190,155,35,35,Direct
3547014,325,90,35,140,105,35,35,Direct
3547064,100,0,35,190,155,35,35,Direct
3547113,450,170,50,325,275,50,50,Direct
3525872,200,25,35,185,150,35,35,Direct
3547413,50,0,35,150,115,35,35,Direct
3547563,100,0,35,245,210,35,35,Direct
3547899,175,5,50,200,150,50,50,Direct
3546927,100,0,35,225,190,35,35,Direct
3548000,250,45,55,125,70,55,55,Direct
3548050,375,120,35,165,130,35,35,Direct
3548199,350,100,35,155,120,35,35,Direct
3548264,125,0,35,150,115,35,35,Direct
3548314,200,30,50,200,150,50,50,Direct
3548414,250,60,35,180,145,35,35,Direct
3548735,400,215,110,475,365,110,110,Direct
3548799,325,130,75,330,255,75,75,Direct
3548886,200,30,35,125,90,35,35,Direct
3526022,175,5,20,185,165,20,20,Direct
3447556,175,5,25,60,35,25,25,Direct
3549336,300,75,35,185,150,35,35,Direct
3549571,75,0,20,180,160,20,20,Direct
3549585,100,0,35,280,245,35,35,Direct
3549686,75,0,35,150,115,35,35,Direct
3549872,300,90,35,160,125,35,35,Direct
3550021,200,30,35,150,115,35,35,Direct
3550071,200,25,35,195,160,35,35,Direct
3550136,125,0,20,90,70,20,20,Direct
3550186,200,5,20,85,65,20,20,Direct
3550222,200,30,40,315,275,40,40,Direct
3550471,175,20,25,70,45,25,25,Direct
3551607,175,10,50,170,120,50,50,Direct
3551707,325,95,35,275,240,35,35,Direct
3549885,350,120,35,185,150,35,35,Direct
3552208,250,65,35,200,165,35,35,Direct
3552393,200,25,35,155,120,35,35,Direct
3552594,75,0,35,160,125,35,35,Direct
3552693,75,0,10,15,5,10,10,Direct
3550172,75,0,60,110,50,60,60,Direct
3552830,125,0,20,75,55,20,20,Direct
3504130,200,25,35,195,160,35,35,Direct
3549100,75,0,35,150,115,35,35,Direct
3536067,125,0,35,225,190,35,35,Direct
3530952,350,130,35,190,155,35,35,Direct
3553429,125,0,35,160,125,35,35,Direct
3553665,325,90,35,165,130,35,35,Direct
3553716,100,0,60,125,65,60,60,Direct
3553730,125,0,35,125,90,35,35,Direct
3553865,125,0,35,170,135,35,35,Direct
3554615,250,65,35,135,100,35,35,Direct
3554651,250,45,40,200,160,40,40,Direct
3531888,325,95,35,185,150,35,35,Direct
3555501,175,15,25,75,50,25,25,Direct
3555887,425,120,50,220,170,50,50,Direct
3555888,100,0,35,190,155,35,35,Direct
3548986,75,0,50,250,200,50,50,Direct
3556488,75,0,20,185,165,20,20,Direct
3556537,100,0,20,75,55,20,20,Direct
3556923,200,20,35,160,125,35,35,Direct
3557523,100,0,34,119,85,34,34,Direct
3557723,100,0,20,170,150,20,20,Direct
3557774,175,10,35,165,130,35,35,Direct
3558210,475,165,50,275,225,50,50,Direct
3552644,100,0,35,190,155,35,35,Direct
3558846,50,0,35,200,165,35,35,Direct
3559446,200,40,50,225,175,50,50,Direct
3560181,300,70,50,375,325,50,50,Direct
3556838,175,15,35,280,245,35,35,Direct
3561718,175,5,35,140,105,35,35,Direct
3561768,175,10,20,45,25,20,20,Direct
3561954,175,5,50,330,280,50,50,Direct
3562018,100,0,35,140,105,35,35,Direct
3562053,550,260,75,350,275,75,75,Direct
3562589,150,0,35,110,75,35,35,Direct
3562653,175,10,50,220,170,50,50,Direct
3562890,125,0,40,250,210,40,40,Direct
3562990,125,0,35,170,135,35,35,Direct
3563575,175,10,20,170,150,20,20,Direct
3563589,325,105,100,250,150,100,100,Direct
3564061,100,0,35,180,145,35,35,Direct
3561618,250,75,35,145,110,35,35,Direct
3564525,125,0,35,170,135,35,35,Direct
3564760,100,0,50,250,200,50,50,Direct
3564862,250,50,35,170,135,35,35,Direct
3564926,50,0,35,245,210,35,35,Direct
3565097,175,10,20,125,105,20,20,Direct
3565162,175,15,50,225,175,50,50,Direct
3566148,150,0,35,265,230,35,35,Direct
3566283,400,145,40,275,235,40,40,Direct
3567534,250,45,50,230,180,50,50,Direct
3568220,100,0,35,160,125,35,35,Direct
3568369,175,15,20,140,120,20,20,Direct
3568556,75,0,35,100,65,35,35,Direct
3568956,75,0,35,150,115,35,35,Direct
3569141,225,35,35,205,170,35,35,Direct
3569305,75,0,50,245,195,50,50,Direct
3570227,150,0,50,220,170,50,50,Direct
3570478,225,45,35,190,155,35,35,Direct
3571277,100,0,50,375,325,50,50,Direct
3571314,125,0,35,125,90,35,35,Direct
3571364,175,15,50,265,215,50,50,Direct
3571613,25,0,20,75,55,20,20,Direct
3572299,200,30,50,230,180,50,50,Direct
2961293,675,335,230,200,165,35,-528,Auction
3129023,300,100,90,90,65,25,-185,Auction
3140655,725,415,174,140,80,60,134,Auction
3155946,325,70,115,150,115,35,-85,Auction
3165153,875,550,569,270,170,100,-26,Auction
3168582,750,375,214,300,150,150,-112.5,Auction
3181516,950,585,255,265,230,35,-404.75,Auction
3194433,1275,925,244,765,455,310,-431,Auction
3206350,2150,1560,385,250,200,50,-1656.5,Auction
3215527,450,185,159,80,60,20,-108.75,Auction
3215812,525,220,269,135,100,35,0,Auction
3226372,975,610,599,430,210,220,-52.5,Auction
3247194,300,85,105,75,55,20,-122.75,Auction
3224100,1600,1150,274,995,625,370,274,Auction
3263740,750,470,174,155,135,20,124,Auction
3267267,775,430,194,225,125,100,-481,Auction
3275040,675,320,199,465,245,220,-393.75,Auction
3266267,600,270,199,150,90,60,206.25,Auction
3276142,825,485,215,475,365,110,-385,Auction
3286472,625,315,200,75,50,25,280.8,Auction
3291216,850,445,299,155,95,60,322.5,Auction
3292905,250,65,79,65,40,25,2,Auction
3297015,350,125,154,125,90,35,4,Auction
3297602,950,590,254,255,155,100,208.34,Auction
3303971,850,545,199,450,340,110,-176,Auction
3272815,850,540,160,270,170,100,-690,Auction
3302950,1325,995,179,500,375,125,1596.5,Auction
3308783,1025,520,349,850,560,290,-126,Auction
3311791,350,115,125,75,50,25,232.25,Auction
3312893,650,370,174,290,240,50,-231.74,Auction
3323240,3100,2530,494,2010,1360,650,251.25,Auction
3325142,400,180,114,95,70,25,114,Auction
3327001,600,240,254,75,50,25,-96,Auction
3327635,850,480,260,595,345,250,-190,Auction
3331460,400,170,124,225,125,100,124,Auction
3343594,575,250,215,160,125,35,-110,Auction
3344445,975,530,365,275,225,50,-210,Auction
3346385,750,390,200,85,60,25,-354.65,Auction
3348006,400,160,134,90,65,25,134,Auction
3350448,325,115,104,103,70,33,-21,Auction
3344896,1000,530,294,200,150,50,-63.2,Auction
3353503,900,520,245,545,295,250,227.75,Auction
3353639,1100,620,370,445,225,220,452.75,Auction
3347772,1100,700,234,275,225,50,-66,Auction
3354222,375,155,90,150,90,60,-110,Auction
3355443,275,90,79,125,90,35,152.5,Auction
3356596,500,195,199,175,140,35,324,Auction
3355311,300,100,80,65,45,20,25.35,Auction
3356949,400,170,124,190,155,35,20,Auction
3359404,525,240,175,145,110,35,342,Auction
3360910,550,225,344,140,105,35,361.8,Auction
3341271,1600,1230,209,1000,600,400,1009,Auction
3362829,325,110,89,110,50,60,-36,Auction
3363250,725,390,184,115,80,35,-466,Auction
3367977,400,210,80,160,140,20,-145,Auction
3368764,250,60,80,145,0,145,5,Auction
3370636,450,145,199,70,55,15,549,Auction
3362446,300,95,80,25,5,20,-51.6,Auction
3371389,750,430,210,525,275,250,105.25,Auction
3372138,1375,945,324,535,285,250,-251,Auction
3372525,575,305,130,215,165,50,-195,Auction
3372925,1025,715,204,275,225,50,221.8,Auction
3367726,350,135,85,35,15,20,-205,Auction
3375248,375,150,105,75,55,20,-622.23,Auction
3375801,400,170,124,190,155,35,-26,Auction
3377405,825,505,210,295,245,50,-140,Auction
3378890,1050,670,274,395,245,150,222.5,Auction
3379077,325,135,80,75,50,25,197,Auction
3380243,375,155,95,102,45,57,-80,Auction
3364169,600,290,204,350,200,150,304,Auction
3382536,200,15,79,30,10,20,29,Auction
3055143,575,280,150,265,165,100,-341,Auction
3116782,700,335,265,185,125,60,-281,Auction
3134312,2325,1865,350,1905,1305,600,90,Auction
3140460,1450,970,299,950,580,370,-76.25,Auction
3160116,775,470,199,500,375,125,189,Auction
3164361,800,530,164,455,235,220,264,Auction
3173420,575,295,174,225,175,50,291,Auction
3199024,450,210,130,275,175,100,33,Auction
3203283,375,135,134,115,80,35,191.25,Auction
3210503,650,305,239,80,55,25,71.25,Auction
3226065,300,75,119,95,70,25,-48.75,Auction
3236792,1200,640,364,380,230,150,146.75,Auction
3249061,700,365,294,135,75,60,44,Auction
3252686,525,235,180,85,60,25,-237.75,Auction
3254491,800,445,245,195,160,35,1127.25,Auction
3272892,350,140,84,75,50,25,134,Auction
3273210,325,75,154,75,50,25,-71,Auction
3238982,1125,790,184,250,200,50,101,Auction
3203001,550,245,199,95,70,25,-201,Auction
3268381,275,85,80,80,60,20,-70,Auction
3289723,1275,795,330,150,115,35,245.25,Auction
3291259,750,355,289,150,115,35,289,Auction
3293249,950,515,264,135,100,35,204.25,Auction
3305549,1450,940,364,995,625,370,-86,Auction
3308157,750,445,195,220,170,50,170,Auction
3308171,1075,605,519,395,345,50,76.25,Auction
3308826,375,155,90,50,30,20,-77.25,Auction
3311616,375,125,140,65,45,20,-114.65,Auction
3319803,625,300,199,240,155,85,-151,Auction
3327559,1825,1205,510,965,595,370,119.5,Auction
3328745,275,90,79,90,70,20,4,Auction
3330950,575,295,174,60,35,25,347.5,Auction
3338255,950,490,350,640,360,280,-75,Auction
3338323,1200,795,295,160,125,35,-815,Auction
3342449,650,305,239,300,150,150,64,Auction
3343853,300,85,120,80,60,20,9,Auction
3344254,1525,1185,315,405,185,220,-167.5,Auction
3344807,700,385,205,250,200,50,214.5,Auction
3179972,900,550,194,450,230,220,194,Auction
3345875,625,320,199,240,140,100,-276,Auction
3347580,725,385,230,285,185,100,-95,Auction
3349151,1300,945,195,930,560,370,-430,Auction
3340377,775,465,164,155,120,35,89,Auction
3351809,350,130,114,95,70,25,-111,Auction
3352342,325,95,110,85,60,25,152,Auction
3356336,1100,645,275,255,155,100,-475,Auction
3357289,650,335,209,400,290,110,-0.59,Auction
3354600,2000,1405,389,835,495,340,489,Auction
3360484,600,320,174,190,155,35,-130,Auction
3363509,275,75,90,115,55,60,172.25,Auction
3363706,1500,1130,260,840,500,340,210,Auction
3364109,425,145,174,115,55,60,-151,Auction
3364760,525,245,174,55,30,25,-152.5,Auction
3365445,600,325,165,285,185,100,165,Auction
3365514,2000,1560,330,745,435,310,-170,Auction
3366131,300,75,94,84,60,24,-31,Auction
3366717,525,220,199,95,70,25,-226,Auction
3367199,300,105,79,160,100,60,104,Auction
3369258,875,440,325,250,150,100,-375,Auction
3369525,875,530,239,75,50,25,189,Auction
3325351,1000,600,294,310,160,150,44,Auction
3370543,450,145,199,125,70,55,99,Auction
3366399,650,350,175,345,195,150,-175,Auction
3372330,925,450,369,190,155,35,69,Auction
3372683,675,310,265,250,150,100,340,Auction
3372848,325,115,94,60,35,25,-231,Auction
3373283,1025,700,175,650,405,245,25,Auction
3373951,700,335,255,245,195,50,330,Auction
3371180,375,135,105,60,35,25,-74.55,Auction
3374687,675,285,284,170,135,35,-191,Auction
3374856,575,295,174,155,120,35,199,Auction
3370040,500,195,199,85,60,25,-101,Auction
3376274,400,215,79,215,180,35,54,Auction
3373751,675,305,214,125,65,60,-261,Auction
3378196,925,570,199,155,95,60,374,Auction
3187585,300,100,80,153,95,58,27.75,Auction
3213189,600,300,189,95,70,25,105.25,Auction
3217626,500,220,174,150,115,35,199,Auction
3201575,1075,605,314,185,125,60,-835.25,Auction
3205519,1050,630,274,770,460,310,124,Auction
3224782,450,145,199,200,100,100,-216,Auction
3248435,425,145,174,70,45,25,181.25,Auction
3256884,1800,1240,454,665,385,280,54,Auction
3267112,1075,695,219,455,235,220,219,Auction
3246856,1025,520,319,325,175,150,-406,Auction
3275000,1200,755,335,620,340,280,1693.25,Auction
3282245,600,300,194,285,235,50,-31,Auction
3283560,1725,1160,369,1435,935,500,-506,Auction
3284067,350,135,105,70,45,25,-269.25,Auction
3284878,500,195,199,75,50,25,-227.5,Auction
3287201,1025,650,265,180,145,35,722.25,Auction
3287862,350,100,115,135,75,60,-152.75,Auction
3276790,575,265,199,125,90,35,24,Auction
3290856,1175,785,225,500,375,125,-253,Auction
3277501,375,140,129,75,50,25,-146,Auction
3292256,1925,1490,329,670,390,280,369,Auction
3298476,375,150,264,135,75,60,-37.5,Auction
3304399,675,385,180,335,185,150,-4.75,Auction
3307189,1325,770,449,175,115,60,-326,Auction
3307675,675,390,174,315,265,50,156.25,Auction
3319818,550,270,174,155,95,60,174,Auction
3321161,625,320,199,260,160,100,24,Auction
3321204,1250,715,365,435,215,220,904,Auction
3321497,725,425,190,210,110,100,-435,Auction
3321872,800,470,224,160,100,60,24,Auction
3323301,575,285,184,215,115,100,351,Auction
3323476,600,295,190,145,125,20,-152.25,Auction
3325191,725,320,239,120,60,60,239,Auction
3326259,1100,565,400,650,370,280,-175,Auction
3326752,950,560,280,360,210,150,-395,Auction
3327177,575,270,199,260,160,100,-176,Auction
3327620,275,80,89,75,50,25,-36,Auction
3330989,1200,735,359,180,160,20,184,Auction
3333411,750,410,189,270,170,100,239,Auction
3340617,1350,750,494,180,145,35,-556,Auction
3347426,825,490,229,400,180,220,104,Auction
3347476,2925,2465,350,2240,1590,650,-725,Auction
3349684,1050,530,410,375,225,150,410,Auction
3350109,375,190,154,120,85,35,-47.5,Auction
3355114,1300,820,309,95,75,20,-691,Auction
3355764,750,335,304,175,140,35,4,Auction
3359819,775,450,219,400,180,220,219,Auction
3359933,1325,800,419,620,340,280,69,Auction
3360001,725,385,230,180,120,60,-220,Auction
3360469,675,340,229,370,220,150,4,Auction
3364231,600,300,174,250,150,100,174,Auction
3363270,925,445,295,150,115,35,-430,Auction
3366017,625,315,180,80,55,25,-145,Auction
3368625,1750,1315,325,755,445,310,25,Auction
3368961,300,90,104,72,50,22,54,Auction
3361355,400,175,90,145,85,60,-135,Auction
3370165,900,500,240,660,380,280,15,Auction
3366571,675,385,180,190,155,35,-220,Auction
3371783,650,365,140,220,120,100,65,Auction
3366435,400,120,174,125,90,35,24,Auction
3373991,350,115,129,150,115,35,154,Auction
3375177,900,585,205,330,180,150,-545,Auction
3376713,500,195,199,190,130,60,174,Auction
3376956,700,420,174,190,130,60,274,Auction
3377574,900,525,234,210,160,50,334,Auction
3378292,475,220,145,180,145,35,-105,Auction
3301080,1200,785,309,335,185,150,9,Auction
3379046,225,35,80,40,20,20,-45,Auction
3381343,500,195,199,120,60,60,-1,Auction
3381543,875,445,469,125,65,60,-6,Auction
3382236,875,550,314,300,225,75,-161,Auction
3100772,1125,730,230,865,525,340,-423,Auction
3148572,275,70,79,80,60,20,104,Auction
3157110,375,150,115,133,100,33,90,Auction
3161926,575,265,204,170,135,35,-131,Auction
3172129,375,155,109,75,55,20,-208.75,Auction
3195993,625,335,175,250,150,100,-340.5,Auction
3200623,1975,1400,469,1525,1025,500,942,Auction
3205460,400,130,134,125,90,35,-166,Auction
3224387,900,565,290,550,300,250,805.5,Auction
3228567,550,240,200,210,160,50,-225,Auction
3230796,675,375,294,90,65,25,126.25,Auction
3231425,700,355,235,180,120,60,-252.65,Auction
3232618,275,80,119,75,55,20,-8,Auction
3244936,875,485,280,220,120,100,-62.75,Auction
3245872,1100,700,290,450,340,110,290,Auction
3248773,700,365,229,260,225,35,-171,Auction
3257961,650,315,294,50,25,25,-156,Auction
3252131,475,170,199,115,55,60,-76,Auction
3258447,3650,2995,439,1810,1210,600,-1986,Auction
3244993,650,290,204,120,60,60,177.5,Auction
3271701,775,350,329,300,225,75,446,Auction
3224780,400,185,109,160,140,20,26,Auction
3274502,275,65,84,85,60,25,-91,Auction
3282733,1525,1110,419,505,255,250,594,Auction
3286335,725,410,205,545,295,250,480,Auction
3290093,525,220,219,125,80,45,94,Auction
3287678,550,225,219,160,125,35,11.8,Auction
3292265,275,75,79,95,75,20,54,Auction
3293344,350,115,119,90,65,25,-132,Auction
3295316,425,175,124,95,70,25,74,Auction
3295702,550,295,149,170,150,20,158,Auction
3301875,675,320,249,315,165,150,-176,Auction
3302904,600,265,265,250,200,50,-243.25,Auction
3311085,325,75,144,105,70,35,-81,Auction
3312328,425,170,149,190,155,35,24,Auction
3319866,375,190,79,150,90,60,177.5,Auction
3324389,275,90,79,100,65,35,79,Auction
3329483,600,290,199,225,175,50,-151,Auction
3335049,475,170,199,45,25,20,-127.5,Auction
3337514,750,445,195,175,115,60,-447.25,Auction
3340708,2000,1525,294,920,550,370,294,Auction
3342730,825,410,269,230,190,40,-156,Auction
3345202,525,210,209,130,70,60,-192.5,Auction
3302854,825,485,210,200,100,100,-15,Auction
3334592,700,325,214,147,85,62,-186,Auction
3349089,525,215,200,95,70,25,-204.65,Auction
3352247,1550,945,495,730,420,310,-305,Auction
3353326,650,370,274,140,105,35,147.5,Auction
3355341,350,115,119,60,35,25,94,Auction
3358856,925,515,284,505,255,250,-141,Auction
3354898,675,375,174,230,130,100,74,Auction
3354305,300,115,79,150,115,35,-96,Auction
3346045,700,355,200,340,190,150,125,Auction
3361807,550,265,179,150,90,60,-71,Auction
3362600,2700,2020,574,1960,1360,600,174,Auction
3365658,325,90,119,100,45,55,-31,Auction
3365801,650,300,240,200,150,50,15,Auction
3366630,325,105,114,160,100,60,89,Auction
3367930,1225,845,274,835,495,340,-505,Auction
3369852,600,235,255,235,135,100,-95,Auction
3370331,925,545,274,480,260,220,122.5,Auction
3370831,350,140,104,55,30,25,-172.5,Auction
3370981,350,135,144,210,110,100,340,Auction
3368702,750,335,249,210,110,100,199,Auction
3373589,575,255,214,290,240,50,-111,Auction
3375218,475,190,175,100,65,35,75,Auction
3375411,1025,650,210,445,245,200,227.5,Auction
3375754,325,105,90,165,105,60,140,Auction
3378676,3325,2715,400,1510,1010,500,-1925,Auction
3381077,300,80,114,115,80,35,89,Auction
3383699,625,320,199,225,125,100,-126,Auction
3351161,900,590,200,110,75,35,-630,Auction
3385021,675,390,144,195,135,60,319,Auction
3386264,850,480,260,200,150,50,-115,Auction
3024368,1275,730,350,465,245,220,460.88,Auction
3175216,425,195,120,200,100,100,-163,Auction
3205381,825,450,214,140,120,20,-311,Auction
3233376,325,115,129,100,65,35,0,Auction
3230866,475,165,204,150,90,60,2.5,Auction
3233191,1000,570,259,230,130,100,-616,Auction
3241813,375,150,94,200,100,100,-177.5,Auction
3254132,1325,835,415,665,385,280,-193.66,Auction
3259197,1475,1035,334,755,445,310,-541,Auction
3263205,475,170,259,160,100,60,-66,Auction
3272165,325,115,94,70,45,25,92.5,Auction
3273067,850,510,189,170,150,20,321.75,Auction
3273852,525,215,200,115,55,60,-217.75,Auction
3273803,600,320,174,125,90,35,-276,Auction
3276794,500,220,174,134,100,34,-126,Auction
3284882,300,105,89,80,55,25,-111,Auction
3280853,600,315,175,240,140,100,349.75,Auction
3290666,750,410,234,230,130,100,-116,Auction
3291600,1075,695,274,165,105,60,-127.5,Auction
3294159,425,145,209,110,50,60,159,Auction
3294793,275,85,80,170,135,35,-179.5,Auction
3292036,1350,925,254,115,55,60,-346,Auction
3300175,525,220,199,85,65,20,-1,Auction
3303634,1425,1020,239,970,600,370,1014,Auction
3304606,375,165,80,75,55,20,366,Auction
3307597,650,330,180,150,115,35,764,Auction
3308299,350,125,90,155,120,35,-317.25,Auction
3307161,950,545,239,435,215,220,-561,Auction
3317021,475,195,174,230,130,100,-1,Auction
3323790,350,115,129,60,35,25,79,Auction
3324124,525,245,174,90,65,25,-151,Auction
3325460,900,545,240,280,180,100,-110,Auction
3328368,850,470,274,255,205,50,224,Auction
3330625,800,365,260,130,95,35,-265,Auction
3333769,425,120,199,85,60,25,749,Auction
3334571,850,395,325,305,230,75,-100,Auction
3339030,550,235,204,160,125,35,-172.5,Auction
3338515,400,145,145,70,45,25,-192.25,Auction
3339900,350,155,89,115,80,35,-61,Auction
3343595,800,365,264,110,75,35,-236,Auction
3348924,800,465,180,315,165,150,-220,Auction
3351383,825,485,200,510,260,250,47.25,Auction
3351634,1425,985,265,1380,930,450,-285,Auction
3352517,1050,590,354,705,395,310,-396,Auction
3353670,675,340,229,100,40,60,-246,Auction
3354540,850,440,300,205,105,100,150,Auction
3351098,1250,840,304,435,215,220,179,Auction
3362113,825,480,235,260,225,35,-240,Auction
3306391,400,170,99,100,40,60,47.5,Auction
3362764,975,515,284,150,115,35,59,Auction
3363500,300,80,110,135,75,60,117.25,Auction
3363902,750,335,289,230,130,100,112.5,Auction
3348039,450,190,150,225,175,50,-25,Auction
3365187,375,110,155,75,55,20,55,Auction
3365438,325,90,104,75,55,20,79,Auction
3366657,1075,695,274,570,320,250,95,Auction
3362713,400,170,99,155,120,35,-201,Auction
3368444,775,465,415,190,155,35,-160,Auction
3369467,1400,1065,229,455,235,220,721.8,Auction
3371001,300,100,94,60,40,20,-31,Auction
3366021,775,385,225,210,160,50,0,Auction
3372473,375,160,109,135,100,35,234,Auction
3372775,700,335,205,125,90,35,-220,Auction
3373475,600,235,220,175,140,35,45,Auction
3373760,375,120,119,95,70,25,-156,Auction
3374360,375,120,145,130,70,60,-80,Auction
3376919,375,120,145,150,115,35,-105,Auction
3377053,600,270,199,225,175,50,-306.06,Auction
3377068,875,415,354,165,105,60,679,Auction
3357414,575,250,215,300,250,50,-135,Auction
3378289,800,485,165,275,175,100,-260,Auction
3378689,1525,1150,265,245,195,50,-685,Auction
3380778,450,145,199,25,5,20,644.54,Auction
3052566,775,465,200,90,65,25,-71,Auction
3094550,1975,1335,530,220,120,100,1491.25,Auction
3158599,400,175,90,170,135,35,-85.25,Auction
3165185,400,115,175,155,95,60,-235,Auction
3172396,475,195,174,125,65,60,-109,Auction
3176213,475,170,199,80,60,20,-101,Auction
3208735,1225,840,275,470,250,220,-909.25,Auction
3216925,325,90,129,95,70,25,77.5,Auction
3238317,1175,825,244,480,260,220,2053.5,Auction
3241895,650,305,289,111,75,36,-187.5,Auction
3247434,550,245,199,80,55,25,31.25,Auction
3256326,1000,600,394,580,330,250,167.5,Auction
3261606,750,400,244,230,130,100,-206,Auction
3267558,2400,1900,614,1430,1025,405,314,Auction
3272209,625,285,215,190,155,35,15,Auction
3265159,725,415,174,260,160,100,531.75,Auction
3279790,425,175,124,95,70,25,99,Auction
3285011,725,400,219,325,250,75,-206,Auction
3285572,575,280,189,65,40,25,-62.5,Auction
3287738,850,485,239,170,110,60,214,Auction
3288529,750,330,275,275,190,85,7.25,Auction
3288538,1500,1150,244,790,710,80,628.5,Auction
3295826,875,525,555,260,210,50,-796.61,Auction
3297098,1425,915,400,640,360,280,-850,Auction
3302033,2475,1875,494,225,125,100,-781,Auction
3304343,575,240,204,195,135,60,-21,Auction
3305811,875,485,284,380,230,150,209,Auction
3309900,350,165,79,25,5,20,-21,Auction
3316107,550,240,200,200,150,50,0,Auction
3317818,750,370,274,215,115,100,-76,Auction
3318022,2875,2285,484,1990,1390,600,4409,Auction
3320660,400,145,149,60,35,25,-101,Auction
3320953,425,145,174,140,80,60,-76,Auction
3322693,875,415,350,40,20,20,-525,Auction
3323191,925,450,369,350,200,150,376.25,Auction
3323200,550,270,174,150,90,60,-152.5,Auction
3320392,1600,940,554,1105,705,400,954,Auction
3329241,575,265,210,260,160,100,567.25,Auction
3330245,2075,1325,644,580,330,250,1819,Auction
3330654,950,560,264,310,160,150,396.75,Auction
3333419,1050,590,294,565,345,220,244,Auction
3333896,300,100,79,75,50,25,-121,Auction
3338444,525,245,174,65,45,20,-79.75,Auction
3341107,825,505,214,160,140,20,-336,Auction
3341316,325,75,144,65,40,25,-107.5,Auction
3302501,1375,930,335,335,185,150,-540,Auction
3343783,800,425,340,180,120,60,197.25,Auction
3346089,775,450,215,125,90,35,-60,Auction
3346425,975,560,305,155,120,35,-420,Auction
3348327,3550,2850,475,870,585,285,-1425,Auction
3350165,575,250,215,150,90,60,-89.65,Auction
3350340,400,140,129,150,90,60,63,Auction
3347502,1000,595,235,745,435,310,154,Auction
3352816,325,130,85,10,5,5,160,Auction
3351837,375,105,129,75,55,20,-96,Auction
3354054,825,405,310,195,135,60,60,Auction
3354956,1500,940,454,340,190,150,377,Auction
3355683,425,120,199,150,90,60,174,Auction
3353718,1300,820,299,695,455,240,174,Auction
3356126,575,320,149,160,100,60,124,Auction
3356326,300,100,90,65,40,25,-60,Auction
3358891,825,535,155,180,160,20,5,Auction
3345421,500,245,149,85,60,25,-151,Auction
3360831,725,440,175,410,355,55,425,Auction
3359466,400,190,84,250,200,50,134,Auction
3362001,500,220,174,155,95,60,-76,Auction
3337942,750,355,234,190,170,20,-216,Auction
3367090,1050,530,410,250,200,50,-140,Auction
3367992,525,215,200,145,85,60,-150,Auction
3368124,2000,1590,300,810,470,340,0,Auction
3359802,850,445,244,235,135,100,-256,Auction
3369596,1375,945,324,85,60,25,-276,Auction
3369621,1675,1160,425,730,420,310,-100,Auction
3356156,800,465,225,195,135,60,-125,Auction
3137123,450,170,174,60,35,25,0,Auction
3162150,600,285,209,160,100,60,-60.25,Auction
3189231,350,125,119,125,90,35,-166,Auction
3144945,950,575,265,310,160,150,-125.5,Auction
3204200,625,300,199,220,170,50,206.25,Auction
3176363,925,585,185,80,60,20,-542.75,Auction
3238503,2300,1820,374,995,625,370,-626,Auction
3242447,725,350,265,395,245,150,-52.75,Auction
3251705,1150,665,394,385,235,150,117.5,Auction
3252307,925,615,200,285,185,100,-34.5,Auction
3253577,625,345,174,150,90,60,49,Auction
3250435,825,410,249,335,260,75,-176,Auction
3268140,1125,645,439,300,150,150,-329.75,Auction
3270882,800,465,225,150,90,60,-244.5,Auction
3265175,2600,1795,559,400,180,220,-791,Auction
3272963,575,250,219,75,55,20,-206,Auction
3277398,450,180,160,125,70,55,235,Auction
3279572,400,215,99,95,70,25,-151,Auction
3235459,275,75,79,110,50,60,-96,Auction
3288011,525,210,209,135,100,35,-116,Auction
3288290,525,220,199,185,125,60,-151,Auction
3293763,725,390,184,205,105,100,207.5,Auction
3295633,900,525,469,340,190,150,194,Auction
3282923,875,415,284,370,295,75,309,Auction
3303364,250,60,80,60,35,25,2.25,Auction
3308001,1275,795,374,700,390,310,499,Auction
3309373,400,150,114,75,50,25,87.5,Auction
3290619,725,355,214,350,200,150,74,Auction
3313224,200,10,80,5,5,0,-72.3,Auction
3315153,900,495,300,200,150,50,-200,Auction
3317234,500,240,154,195,135,60,115,Auction
3319935,975,580,230,535,315,220,-45,Auction
3325656,325,115,84,85,60,25,84,Auction
3325958,1775,1345,324,540,290,250,-827.5,Auction
3326194,750,405,235,260,160,100,-40,Auction
3327857,1325,905,314,790,480,310,962.5,Auction
3322950,775,375,234,155,120,35,-266,Auction
3332067,600,315,175,229,180,49,-552.75,Auction
3334116,525,245,174,40,20,20,-201,Auction
3337517,550,235,209,115,55,60,-191,Auction
3337447,825,435,225,255,205,50,-25,Auction
3339155,350,115,129,145,85,60,229,Auction
3340691,325,135,84,145,85,60,-41,Auction
3342068,1325,840,304,540,415,125,-621,Auction
3344433,400,170,99,205,155,50,-10.75,Auction
3344978,325,115,104,200,100,100,-21,Auction
3348084,350,135,85,135,100,35,-65,Auction
3348279,400,160,134,50,30,20,124.25,Auction
3350249,3050,2380,454,1365,915,450,-1896,Auction
3350987,1275,690,475,805,465,340,-275,Auction
3351285,525,215,200,55,30,25,-75,Auction
3351394,700,360,244,250,200,50,194,Auction
3354838,525,240,175,75,55,20,-114,Auction
3355365,525,220,229,100,40,60,179,Auction
3356667,1675,1080,485,860,520,340,210,Auction
3358039,325,135,80,45,25,20,-245,Auction
3300020,975,630,239,605,325,280,814,Auction
3336447,2850,2315,344,905,535,370,494,Auction
3363319,1050,530,410,415,195,220,-415,Auction
3363719,700,300,290,400,180,220,-235,Auction
3364598,600,290,199,135,75,60,-101,Auction
3364825,900,480,314,420,200,220,-286,Auction
3363655,1375,900,295,665,385,280,-555,Auction
3371114,600,290,199,115,80,35,-127.5,Auction
3371307,650,320,220,265,215,50,-30,Auction
3348577,575,255,199,260,225,35,399,Auction
3374992,2250,1765,375,1370,920,450,175,Auction
3375292,325,115,84,75,50,25,-191,Auction
3379195,400,135,140,200,110,90,-64.65,Auction
3379338,625,300,199,135,75,60,22.5,Auction
3380508,525,195,199,170,150,20,124,Auction
3102229,800,410,280,125,0,125,366.75,Auction
3114997,875,455,310,385,310,75,-84.5,Auction
3130530,275,70,80,100,65,35,-323,Auction
3161525,1425,950,369,150,130,20,385,Auction
3189056,475,190,225,65,40,25,-117.25,Auction
3209548,525,260,159,145,95,50,-312.5,Auction
3214962,500,220,174,95,70,25,139.5,Auction
3217870,950,630,214,465,245,220,-302,Auction
3224395,600,280,210,285,185,100,170.75,Auction
3230045,450,195,149,200,155,45,97,Auction
3233312,500,195,269,135,100,35,86,Auction
3240064,350,115,129,100,40,60,-147.5,Auction
3249765,1325,850,369,650,370,280,-6,Auction
3250767,525,220,199,90,65,25,-126,Auction
3251396,300,100,90,70,45,25,199,Auction
3259148,550,300,110,250,200,50,-182.75,Auction
3266813,700,340,254,200,150,50,11.75,Auction
3268315,625,320,199,225,125,100,-126,Auction
3265677,575,295,174,85,60,25,-301,Auction
3273222,1400,855,439,405,185,220,-661,Auction
3273329,1175,830,235,650,370,280,-40,Auction
3278704,2425,1955,349,495,425,70,424,Auction
3278802,500,245,149,170,135,35,141.8,Auction
3281819,350,135,109,70,50,20,124.25,Auction
3287779,675,335,234,95,70,25,-167.5,Auction
3283482,950,640,174,165,105,60,-276,Auction
3284763,1825,1260,455,555,430,125,530,Auction
3293359,1025,670,245,250,200,50,-780,Auction
3294972,250,45,79,55,30,25,36.25,Auction
3295101,350,135,94,125,90,35,69,Auction
3295367,400,170,124,155,120,35,-76,Auction
3297037,350,150,90,30,10,20,-135,Auction
3297039,1000,575,315,130,70,60,-410,Auction
3300924,875,525,240,75,50,25,-160,Auction
3301224,1125,680,339,745,435,310,314,Auction
3312956,2700,2190,404,875,535,340,104,Auction
3317659,450,145,229,120,60,60,79,Auction
3317902,325,115,84,200,100,100,-61,Auction
3319465,600,340,150,160,140,20,1234,Auction
3319865,525,220,199,125,70,55,218,Auction
3321739,225,35,80,10,5,5,-145,Auction
3323511,375,120,149,25,5,20,-51,Auction
3328225,1125,735,229,1005,605,400,1077.5,Auction
3328832,375,125,140,130,70,60,-27.75,Auction
3333971,450,145,199,135,75,60,124,Auction
3334214,400,175,115,180,145,35,-85,Auction
3333371,700,350,204,215,165,50,-196,Auction
3335377,300,85,99,75,55,20,81.75,Auction
3334141,1450,1015,264,155,120,35,-286,Auction
3340430,375,190,79,160,125,35,-53.2,Auction
3342136,650,305,199,115,80,35,-376,Auction
3345146,650,270,249,255,215,40,145,Auction
3346139,900,495,235,270,170,100,-490,Auction
3349990,700,350,240,190,155,35,-185,Auction
3354661,350,125,94,125,65,60,244,Auction
3355642,300,100,94,75,50,25,111.8,Auction
3331640,950,540,300,340,190,150,-25,Auction
3358414,350,90,174,95,70,25,99,Auction
3358748,850,505,235,470,250,220,-90,Auction
3350319,775,385,280,390,240,150,55,Auction
3360577,400,170,99,65,40,25,-51,Auction
3361758,775,390,224,245,195,50,-126,Auction
3361649,925,475,340,265,215,50,1347.25,Auction
3362551,2575,1850,619,670,390,280,926.75,Auction
3364764,550,270,174,150,90,60,524,Auction
3362894,975,560,249,790,480,310,374,Auction
3365702,375,185,80,135,100,35,512.25,Auction
3367565,2025,1545,374,1360,910,450,1049,Auction
3368608,400,115,175,140,105,35,150,Auction
3369603,825,445,215,280,230,50,-160,Auction
3359048,375,150,94,70,45,25,-181,Auction
2888251,475,180,175,110,70,40,-211,Auction
3050550,325,120,95,65,40,25,-63.25,Auction
3097043,550,260,175,135,115,20,104,Auction
3120743,1600,1095,395,175,115,60,-245.75,Auction
3146764,925,570,249,180,160,20,549,Auction
3157911,1125,645,374,465,245,220,-359,Auction
3165213,300,115,79,145,85,60,307.5,Auction
3174287,925,500,319,385,235,150,-521,Auction
3185283,625,320,199,90,65,25,-193.25,Auction
3190248,500,190,200,165,130,35,350,Auction
3188276,525,245,154,60,35,25,29,Auction
3216271,475,170,199,65,40,25,0,Auction
3220964,650,330,210,255,155,100,-182.75,Auction
3229738,2400,2020,274,1560,1165,395,874,Auction
3233968,275,75,94,60,35,25,44,Auction
3236826,875,485,269,470,250,220,144,Auction
3237027,900,500,235,345,195,150,-432.75,Auction
3258569,775,415,469,335,185,150,-6,Auction
3260240,625,320,199,175,140,35,-195.79,Auction
3276016,775,425,240,485,265,220,15.01,Auction
3282569,1875,1345,969,820,480,340,494,Auction
3236776,275,85,84,85,60,25,9,Auction
3286613,400,190,104,240,190,50,4,Auction
3295038,475,210,159,175,115,60,-166,Auction
3296023,375,170,99,145,110,35,-76,Auction
3296960,750,410,189,215,115,100,-161,Auction
3296673,1250,800,274,220,120,100,447.5,Auction
3299146,1200,820,344,100,40,60,44,Auction
3301854,850,470,274,350,275,75,-276,Auction
3308541,1775,1375,235,820,480,340,-540,Auction
3316744,525,220,254,265,215,50,23,Auction
3322646,375,120,139,150,115,35,146.25,Auction
3324232,600,320,174,455,235,220,99,Auction
3324918,350,90,154,35,15,20,-53.2,Auction
3320473,450,170,174,175,115,60,74,Auction
3331420,1050,670,270,620,340,280,270,Auction
3331605,200,15,79,20,10,10,163,Auction
3332956,525,280,135,135,75,60,-190,Auction
3335964,400,150,144,70,45,25,-82.5,Auction
3336685,500,245,149,80,55,25,49,Auction
3338022,1425,1015,300,100,65,35,-325,Auction
3343988,1600,1130,364,300,225,75,1064,Auction
3345710,300,80,110,60,35,25,8,Auction
3342602,500,180,214,150,90,60,214,Auction
3350504,225,35,80,50,25,25,-45,Auction
3351826,650,270,185,225,185,40,-240,Auction
3352076,775,465,189,195,135,60,114,Auction
3352726,500,195,199,110,50,60,-51,Auction
3354683,325,130,85,95,70,25,92.75,Auction
3354884,300,110,80,150,90,60,-140,Auction
3356205,875,590,175,105,45,60,252.5,Auction
3357592,550,210,214,190,170,20,164,Auction
3317129,1225,720,399,205,155,50,-601,Auction
3356955,1500,905,390,128,75,53,224.5,Auction
3359578,800,365,325,190,155,35,-175,Auction
3363708,725,385,230,300,150,150,212.25,Auction
3364043,1075,605,364,435,215,220,-436,Auction
3357641,700,405,150,485,375,110,-175,Auction
3354933,1275,695,379,445,225,220,-296,Auction
3365444,700,360,254,75,50,25,304,Auction
3365880,725,315,300,210,160,50,-25,Auction
3366029,375,155,90,205,105,100,-195,Auction
3368888,1175,825,244,350,200,150,69,Auction
3352962,825,505,214,165,105,60,528,Auction
3370995,850,420,255,385,310,75,-195,Auction
3368337,725,375,200,265,165,100,437.5,Auction
3369874,2325,1725,465,165,130,35,-160,Auction
3369974,1325,955,210,1110,710,400,585,Auction
3374739,700,375,180,190,145,45,30,Auction
3370860,1775,1250,400,1520,1020,500,190,Auction
3376361,450,165,175,95,70,25,-129.55,Auction
3377362,700,370,220,265,165,100,-5,Auction
3380755,1150,720,324,212,160,52,324,Auction
3380956,900,545,245,300,250,50,-107,Auction
3063864,1225,780,335,375,225,150,-658,Auction
3068651,350,115,100,50,25,25,-61,Auction
3091583,1400,995,295,400,180,220,-971,Auction
3104351,450,140,200,100,40,60,-196.25,Auction
3154487,675,380,189,200,100,100,14,Auction
3154980,275,75,94,95,70,25,142.5,Auction
3164672,725,385,230,380,330,50,0,Auction
3185600,750,395,249,245,195,50,25.51,Auction
3179389,750,390,200,65,45,20,-192.25,Auction
3198475,700,300,290,320,270,50,95.5,Auction
3211375,800,490,164,510,260,250,656.8,Auction
3213842,1275,735,434,460,240,220,1151,Auction
3233260,550,205,405,105,70,35,55,Auction
3231656,825,425,274,240,205,35,-218.75,Auction
3207460,950,560,229,240,140,100,-347.5,Auction
3254920,550,295,149,85,60,25,91.8,Auction
3257035,725,415,294,145,95,50,634,Auction
3265284,650,305,239,215,165,50,186.75,Auction
3244594,375,150,94,160,100,60,-181,Auction
3267731,1775,1255,414,1285,835,450,1021.75,Auction
3265893,350,110,105,80,55,25,0,Auction
3260438,725,415,174,200,150,50,-201,Auction
3277184,625,285,234,65,40,25,-41,Auction
3277984,1050,650,294,160,110,50,-606,Auction
3253750,650,305,229,285,250,35,-138.75,Auction
3282698,600,290,204,95,70,25,-146,Auction
3290769,725,385,230,140,80,60,489,Auction
3293479,350,135,89,160,125,35,89,Auction
3298559,550,225,244,120,60,60,269,Auction
3300372,1325,800,419,485,265,220,-306,Auction
3306120,575,265,204,60,35,25,29,Auction
3311970,625,335,180,80,60,20,-320,Auction
3317577,1125,680,339,825,485,340,-161,Auction
3317943,725,440,299,390,240,150,166,Auction
3320760,1575,1040,425,1075,675,400,1700,Auction
3315114,500,195,199,165,130,35,-51,Auction
3323704,375,135,134,150,115,35,-16,Auction
3324129,650,355,224,420,280,140,274,Auction
3329184,300,100,79,105,45,60,54,Auction
3330949,350,105,129,60,35,25,129,Auction
3334498,1525,960,459,840,500,340,794,Auction
3337808,450,170,174,130,70,60,197.5,Auction
3339003,350,125,119,160,125,35,119,Auction
3346198,575,265,204,280,180,100,-171,Auction
3346691,725,315,315,195,160,35,-285,Auction
3347725,725,425,194,505,255,250,-181,Auction
3349908,850,400,344,435,215,220,69,Auction
3350567,925,590,229,485,375,110,-246,Auction
3350610,1600,1100,394,145,85,60,219,Auction
3353409,2275,1795,329,1155,755,400,254,Auction
3354388,475,165,200,215,165,50,0,Auction
3358157,375,120,119,80,55,25,119,Auction
3351112,1700,1275,254,1175,775,400,177.35,Auction
3360161,350,160,80,170,150,20,39,Auction
3336804,625,345,135,30,10,20,-315,Auction
3362867,350,150,84,75,50,25,-116,Auction
3363012,400,215,79,225,175,50,-21,Auction
3363578,400,210,80,185,125,60,-173.75,Auction
3360259,700,375,174,160,125,35,179.21,Auction
3368828,575,290,175,305,255,50,-409.39,Auction
3369194,475,170,199,75,50,25,216.8,Auction
3369530,375,155,110,150,90,60,-165,Auction
3370925,1050,695,249,540,290,250,-201,Auction
3372695,1350,820,364,525,275,250,189,Auction
3373708,525,215,200,125,65,60,-150,Auction
3374206,900,435,294,480,260,220,94,Auction
3374665,850,445,299,85,60,25,324,Auction
3375635,800,520,174,375,300,75,224,Auction
3363335,475,230,110,145,85,60,-190,Auction
3377273,750,445,195,160,125,35,-258.75,Auction
3377609,525,220,199,145,0,145,-126,Auction
3378150,525,240,175,220,130,90,25,Auction
3380090,575,290,175,195,160,35,150,Auction
3367488,725,385,185,250,200,50,-240,Auction
2881488,575,280,175,195,155,40,-136,Auction
2910218,2725,2195,330,1560,1310,250,609,Auction
3063229,400,135,155,85,60,25,244,Auction
3088272,1075,690,220,715,405,310,493.5,Auction
3166688,2025,1590,329,675,395,280,989,Auction
3194675,475,170,199,135,75,60,-176,Auction
3209779,1875,1290,479,1470,970,500,504,Auction
3216131,1000,630,214,200,100,100,-712.5,Auction
3219918,1925,1530,289,1050,650,400,-1062.5,Auction
3202470,525,270,115,95,70,25,-327.25,Auction
3216674,1075,715,469,335,260,75,194,Auction
3234808,300,95,95,80,60,20,-107.5,Auction
3237509,900,570,224,325,175,150,224,Auction
3244611,950,560,229,455,235,220,-188.25,Auction
3271540,300,115,79,125,90,35,52.5,Auction
3272319,950,540,300,790,480,310,290,Auction
3273641,450,170,174,195,160,35,197.5,Auction
3266217,375,120,119,88,65,23,0,Auction
3282415,1675,1080,489,790,480,310,264,Auction
3287160,900,435,359,285,235,50,-349,Auction
3290647,725,410,205,85,60,25,-320,Auction
3299428,675,335,219,170,135,35,126.75,Auction
3302786,1150,695,345,570,320,250,-522.75,Auction
3305537,850,470,219,480,260,220,169,Auction
3308016,2850,2315,429,135,75,60,334,Auction
3300814,375,170,99,100,40,60,-176,Auction
3317126,2075,1490,665,505,440,65,-810,Auction
3317776,750,430,214,440,220,220,339,Auction
3315890,700,300,230,125,90,35,-348.75,Auction
3318762,625,320,174,210,160,50,281.75,Auction
3319391,800,405,234,355,280,75,-16,Auction
3303422,575,295,174,10,5,5,-326,Auction
3327536,1125,585,430,410,355,55,-145,Auction
3330430,425,140,175,155,95,60,-25,Auction
3332695,400,125,135,95,75,20,35,Auction
3332759,900,505,234,240,190,50,-66,Auction
3333138,350,115,125,125,90,35,0,Auction
3333981,375,105,149,70,45,25,-102.5,Auction
3287803,1200,695,315,730,420,310,-285,Auction
3336353,425,115,200,95,75,20,-67.75,Auction
3340297,375,150,115,200,150,50,115,Auction
3348371,775,415,269,100,65,35,-156,Auction
3348121,500,195,199,235,185,50,-51,Auction
3352722,525,245,174,65,40,25,641.8,Auction
3356509,1125,790,229,410,190,220,419.25,Auction
3354680,325,90,104,120,85,35,79,Auction
3338711,900,520,270,215,115,100,-5,Auction
3358138,1525,1135,415,690,410,280,-585,Auction
3359131,375,150,115,125,65,60,115,Auction
3343291,750,430,179,400,180,220,136.25,Auction
3359817,625,250,245,55,30,25,-105,Auction
3350786,400,135,140,95,70,25,-60,Auction
3362225,1000,650,394,665,385,280,3176.25,Auction
3362911,1925,1200,619,115,55,60,-906,Auction
3365676,2825,2290,340,1360,910,450,-256.99,Auction
3366462,525,220,199,225,175,50,266.8,Auction
3366426,350,160,80,65,40,25,-95,Auction
3367305,425,145,174,135,75,60,549,Auction
3367998,375,140,129,125,90,35,-21,Auction
3369134,500,260,130,160,125,35,-145,Auction
3369820,2450,1765,515,325,175,150,137.55,Auction
3371642,650,330,170,300,225,75,-130,Auction
3373471,350,105,129,95,70,25,79,Auction
3374007,675,335,234,265,165,100,9,Auction
3366362,750,460,150,605,325,280,125,Auction
3375229,500,195,199,230,190,40,33,Auction
3375250,550,245,199,95,70,25,-126,Auction
3376265,1625,1040,479,625,345,280,254,Auction
3379916,400,180,89,75,50,25,889,Auction
3380223,2125,1645,374,1255,805,450,649,Auction
3381409,550,265,179,115,55,60,176,Auction
3379337,350,105,139,75,50,25,589,Auction
3318362,275,75,94,75,50,25,-31,Auction
3385639,700,300,290,185,150,35,-88.75,Auction
3386468,1800,1240,364,940,625,315,364,Auction
2938857,1925,1515,290,905,535,370,-346,Auction
3054324,1825,1350,715,100,65,35,69,Auction
3127324,750,460,180,335,260,75,-241,Auction
3164346,2450,1830,514,895,555,340,1744,Auction
3206727,500,215,175,110,50,60,-223.75,Auction
3208199,500,195,199,150,115,35,-109,Auction
3208666,600,270,224,65,45,20,-226,Auction
3179451,350,115,119,70,45,25,0,Auction
3231995,475,165,200,95,70,25,-55,Auction
3233049,400,140,154,115,55,60,-171,Auction
3217341,400,145,119,90,65,25,-81,Auction
3246753,1025,595,320,300,150,150,260,Auction
3251901,925,480,434,365,215,150,9,Auction
3254727,650,305,199,225,175,50,131.25,Auction
3255527,600,330,164,160,115,45,164,Auction
3220831,3225,2635,389,1180,780,400,-1436,Auction
3261411,500,245,149,165,115,50,122.5,Auction
3263832,375,135,134,80,55,25,32.5,Auction
3269716,350,105,139,155,95,60,139,Auction
3289419,2225,1740,300,1040,640,400,649.75,Auction
3299366,1650,1105,435,1310,860,450,453.5,Auction
3301352,975,610,219,265,165,100,-6,Auction
3301970,875,585,149,285,185,100,-476,Auction
3304913,475,230,110,205,155,50,153.5,Auction
3303659,875,460,249,165,105,60,74,Auction
3307539,225,40,79,60,35,25,-3.2,Auction
3310997,775,450,215,475,255,220,97.25,Auction
3273324,1800,1190,429,180,145,35,-1288.75,Auction
3295421,450,210,105,190,155,35,-162.25,Auction
3317214,450,170,174,80,60,20,-26,Auction
3322026,750,445,199,175,115,60,-101,Auction
3250514,725,425,150,85,60,25,-25,Auction
3317081,600,320,174,187,150,37,-326,Auction
3331335,300,95,85,95,70,25,-125,Auction
3333811,575,265,199,115,55,60,-102.5,Auction
3335547,825,460,209,180,160,20,118.5,Auction
3336384,900,415,275,93,70,23,-334.75,Auction
3339877,1575,1000,469,645,505,140,94,Auction
3340427,800,420,215,225,125,100,-385,Auction
3349166,750,410,234,640,360,280,-416,Auction
3341796,300,85,109,75,50,25,9,Auction
3353582,275,85,80,100,40,60,-105,Auction
3348183,625,300,199,210,160,50,206.75,Auction
3354735,1300,815,790,215,165,50,490,Auction
3358512,450,170,174,80,55,25,-301,Auction
3349119,875,500,265,540,290,250,-185,Auction
3359261,900,505,234,175,115,60,34,Auction
3361955,400,170,174,90,65,25,124,Auction
3362419,475,170,199,70,45,25,-76,Auction
3363341,275,55,114,40,20,20,-61,Auction
3363809,650,355,189,195,160,35,-161,Auction
3363941,475,195,174,165,105,60,177.5,Auction
3352910,400,135,155,110,75,35,5,Auction
3332454,1500,935,490,1060,660,400,382,Auction
3365464,775,430,239,275,175,100,189,Auction
3365227,625,335,184,155,120,35,-241,Auction
3366282,550,300,140,115,55,60,-160,Auction
3367268,400,180,89,60,35,25,-136,Auction
3368536,275,60,144,10,5,5,94,Auction
3369357,750,385,220,285,250,35,-180,Auction
3309143,450,170,174,135,75,60,24,Auction
3371579,1000,650,244,465,245,220,76.75,Auction
3373501,850,400,344,135,80,55,594,Auction
3350455,925,450,294,135,75,60,244,Auction
3369940,775,430,239,185,125,60,396.25,Auction
3374905,375,185,80,170,150,20,-70,Auction
3375191,1350,885,344,315,165,150,794,Auction
3374587,675,370,155,370,295,75,55,Auction
3377313,1425,950,369,1270,820,450,444,Auction
3377360,700,370,240,365,215,150,-210,Auction
3377496,700,395,199,565,315,250,599,Auction
3379718,650,300,240,120,60,60,-235,Auction
3380789,750,370,270,85,65,20,-130,Auction
3382244,525,240,175,155,120,35,-25,Auction
3382526,1950,1280,564,1010,610,400,1364,Auction
3126481,625,290,199,275,225,50,-242,Auction
3182216,425,115,200,120,60,60,7.75,Auction
3186445,900,500,234,405,185,220,194,Auction
3197260,325,105,114,120,100,20,-28.75,Auction
3188904,925,445,295,380,230,150,277.75,Auction
3215810,300,60,164,160,0,160,-3.75,Auction
3236968,400,185,85,175,115,60,-207.75,Auction
3240342,600,280,214,260,160,100,71.75,Auction
3261568,350,115,104,125,90,35,202.5,Auction
3203612,600,300,154,220,120,100,-242.5,Auction
3267486,1600,1175,315,1360,910,450,480,Auction
3276727,1250,735,405,150,115,35,-775,Auction
3277561,400,140,154,90,65,25,-176,Auction
3278233,975,480,385,555,305,250,1242.75,Auction
3278982,400,140,154,110,50,60,-146,Auction
3287291,1300,910,284,180,145,35,-916,Auction
3294528,450,145,199,75,50,25,-101,Auction
3304620,825,490,229,260,160,100,4,Auction
3304973,275,90,79,85,60,25,79,Auction
3315048,600,300,174,265,215,50,170,Auction
3315218,2175,1695,374,1730,1180,550,74,Auction
3323974,1400,970,324,150,115,35,16,Auction
3324259,375,115,124,55,30,25,-151,Auction
3325178,425,145,174,90,65,25,96,Auction
3325463,250,55,89,75,50,25,-61,Auction
3328386,525,260,125,250,150,100,-127.75,Auction
3328973,375,135,169,125,90,35,-133,Auction
3330926,350,115,129,80,55,25,129,Auction
3331075,1425,850,469,705,395,310,569,Auction
3338129,825,450,269,80,55,25,-6,Auction
3338295,650,345,195,260,225,35,354,Auction
3338614,1025,650,265,350,300,50,-360,Auction
3288244,1300,845,349,875,535,340,-251,Auction
3342039,975,530,270,515,265,250,-480,Auction
3343511,375,150,115,140,105,35,-135,Auction
3312708,500,195,199,130,70,60,299,Auction
3347821,400,190,84,45,25,20,-216,Auction
3348276,7075,5905,850,6180,5865,315,1275,Auction
3352152,400,150,164,10,5,5,-36,Auction
3354590,950,515,409,270,170,100,234,Auction
3359355,2125,1365,650,1190,790,400,-650,Auction
3338499,1875,1305,370,1505,1005,500,-327.5,Auction
3360121,1225,655,460,290,190,100,-165,Auction
3361746,875,530,269,530,280,250,269,Auction
3362129,1650,1195,349,1220,770,450,349,Auction
3363784,475,165,204,85,60,25,-21,Auction
3368762,825,380,335,250,150,100,-265,Auction
3369634,450,140,200,105,70,35,0,Auction
3370017,425,145,174,85,60,25,-48.76,Auction
3370536,1025,520,399,445,335,110,174,Auction
3371272,250,65,79,90,65,25,79,Auction
3371604,675,355,179,555,335,220,504,Auction
3371855,1325,905,490,240,140,100,-335,Auction
3371889,1150,605,744,195,160,35,-206,Auction
3371957,850,480,260,175,115,60,81.25,Auction
3373910,975,625,240,185,125,60,11.25,Auction
3375233,1200,675,419,410,355,55,228.5,Auction
3375348,300,115,79,88,65,23,29,Auction
3377237,950,515,329,175,140,35,-321,Auction
3377654,725,425,194,215,165,50,-200.46,Auction
3377820,925,570,279,185,125,60,54,Auction
3300208,1300,840,280,95,75,20,-20,Auction
3383138,500,195,199,195,160,35,399,Auction
3383789,2300,1860,330,1205,755,450,-220,Auction
3383870,425,185,140,205,155,50,-160,Auction
3384338,925,615,389,345,195,150,464,Auction
3360657,625,335,180,200,100,100,-174.65,Auction
3385444,325,140,79,160,125,35,79,Auction
3369915,525,240,175,250,150,100,-175,Auction
3386227,1475,915,454,1055,655,400,229,Auction
3386831,1575,1155,314,1000,600,400,439,Auction
3388818,500,175,215,160,125,35,-10,Auction
2995765,600,315,190,280,180,100,-404.25,Auction
3170225,900,595,199,605,325,280,273.75,Auction
3179170,800,410,284,265,215,50,299,Auction
3181993,400,200,79,120,60,60,-71,Auction
3213830,600,295,175,100,65,35,59,Auction
3218461,350,135,109,150,115,35,7,Auction
3229170,1100,660,334,180,160,20,-282,Auction
3235573,550,285,175,70,45,25,-242.5,Auction
3245668,1425,805,514,500,375,125,381.5,Auction
3246519,900,570,224,540,290,250,248.75,Auction
3253370,350,105,114,120,60,60,-186,Auction
3262381,1150,665,379,520,270,250,1197.5,Auction
3264803,700,355,235,95,70,25,320,Auction
3227549,1225,780,295,270,220,50,-547.75,Auction
3189295,1450,1015,329,640,360,280,-521,Auction
3261344,575,295,174,340,190,150,108.5,Auction
3287618,800,450,240,160,140,20,165,Auction
3288218,300,95,95,55,30,25,70,Auction
3297077,1500,940,454,350,200,150,477.5,Auction
3298027,550,295,149,180,160,20,158,Auction
3304079,400,170,109,155,105,50,109,Auction
3304130,1525,880,745,275,175,100,60,Auction
3305080,800,365,329,345,195,150,-96,Auction
3305430,725,315,315,205,105,100,-94.75,Auction
3309610,750,370,240,275,175,100,-185,Auction
3320591,1225,755,364,400,180,220,-186,Auction
3326022,325,120,95,85,65,20,-220,Auction
3334560,600,300,194,155,95,60,-182.5,Auction
3334931,650,365,175,210,110,100,-150,Auction
3340125,725,375,260,215,115,100,42.25,Auction
3341447,1450,895,445,965,595,370,-197.25,Auction
3342084,550,245,199,110,50,60,191.8,Auction
3342733,525,240,175,25,5,20,-225,Auction
3349136,400,160,134,180,160,20,243,Auction
3351793,700,300,280,175,140,35,130,Auction
3351357,825,385,319,425,205,220,-406,Auction
3352780,550,235,209,110,50,60,-41,Auction
3352893,625,285,200,325,275,50,25,Auction
3354766,625,300,219,215,165,50,-260.46,Auction
3355302,600,315,175,140,80,60,-300,Auction
3355738,700,340,254,300,150,150,54,Auction
3357524,325,130,85,140,105,35,-132.25,Auction
3358646,525,215,200,210,160,50,-175,Auction
3264938,600,280,204,130,70,60,104,Auction
3360618,1475,1095,274,470,250,220,-451,Auction
3361368,250,60,80,60,35,25,-80,Auction
3361367,850,445,239,465,245,220,239,Auction
3362053,975,530,335,260,210,50,-440,Auction
3362239,1950,1410,345,915,545,370,395,Auction
3365111,650,380,164,245,195,50,206.8,Auction
3366798,725,415,259,244,195,49,309,Auction
3367569,1650,1055,390,1395,945,450,740,Auction
3351307,325,105,110,95,70,25,-40,Auction
3368456,325,90,129,80,55,25,-21,Auction
3368620,400,160,119,190,155,35,19,Auction
3368720,1450,1015,264,675,395,280,264,Auction
3370877,800,405,230,295,195,100,30,Auction
3370977,375,135,134,130,70,60,109,Auction
3371013,425,120,199,90,65,25,24,Auction
3371163,1525,1000,415,760,450,310,190,Auction
3371213,1300,815,375,765,455,310,625,Auction
3360767,375,120,115,150,115,35,-135,Auction
3371564,800,390,304,485,375,110,-96,Auction
3373936,400,215,79,20,10,10,-246,Auction
3372549,625,340,175,135,100,35,125,Auction
3374821,350,100,144,75,50,25,-81,Auction
3375022,725,375,204,150,90,60,271.8,Auction
3376158,625,335,180,185,150,35,-270,Auction
3376693,3750,2575,418.09,155,0,155,-1110,Auction
3377730,1475,885,390,255,220,35,-560,Auction
3378801,775,390,279,215,115,100,-346,Auction
3379115,375,150,90,90,65,25,101,Auction
3009860,1075,625,340,555,305,250,-415.25,Auction
3067388,275,75,90,120,60,60,104,Auction
3135506,625,290,199,155,120,35,-85.75,Auction
3161778,1350,820,424,600,320,280,234.8,Auction
3208806,625,300,200,150,115,35,-117.25,Auction
3226556,600,320,174,150,115,35,-76,Auction
3234293,550,245,199,125,90,35,-151,Auction
3244253,750,395,199,260,225,35,-59,Auction
3252043,1375,1015,254,160,125,35,-947.5,Auction
3253013,425,170,149,70,45,25,-152.5,Auction
3253064,575,295,174,125,90,35,-151,Auction
3269740,2825,2150,1219,160,125,35,-513.2,Auction
3208959,650,335,204,160,100,60,-246,Auction
3252128,650,355,189,250,200,50,221.25,Auction
3283595,475,170,199,85,60,25,-76,Auction
3305308,625,305,199,135,80,55,22.5,Auction
3306308,600,320,174,435,215,220,858,Auction
3306929,375,185,80,150,115,35,58.5,Auction
3313411,675,355,210,315,165,150,147,Auction
3319997,400,170,124,145,85,60,124,Auction
3322405,1725,1205,410,110,50,60,-115,Auction
3326513,500,190,200,185,150,35,0,Auction
3328102,2225,1450,665,620,340,280,319,Auction
3327485,275,75,79,75,50,25,-96,Auction
3331110,550,225,219,125,90,35,-31,Auction
3332746,500,195,199,145,110,35,-151,Auction
3328502,400,160,109,200,150,50,212.5,Auction
3339098,1825,1425,290,910,540,370,-135,Auction
3339334,500,220,194,35,15,20,69,Auction
3341691,4075,3480,489,2550,1850,700,314,Auction
3353587,2000,1265,629,1165,765,400,1209,Auction
3354123,400,160,134,180,120,60,-16,Auction
3354323,350,135,109,60,35,25,134,Auction
3358701,625,320,199,125,65,60,-176,Auction
3353002,575,305,130,70,45,25,-305,Auction
3360826,300,115,79,85,60,25,379,Auction
3361075,650,355,189,140,105,35,214,Auction
3362732,375,100,165,120,85,35,-130,Auction
3364470,825,525,219,225,175,50,236.8,Auction
3366840,775,410,210,430,210,220,-440,Auction
3367712,425,120,199,80,60,20,-101,Auction
3367876,350,105,154,95,70,25,4,Auction
3367961,1675,1080,394,190,155,35,-281,Auction
3366940,1300,865,260,180,145,35,-465,Auction
3368748,525,220,199,195,175,20,-26,Auction
3369548,4525,3735,605,2750,2050,700,3680,Auction
3369699,1050,590,354,740,430,310,204,Auction
3364019,250,60,80,60,35,25,55,Auction
3373392,500,225,150,190,155,35,-200,Auction
3374013,3125,2550,469,2990,2290,700,744,Auction
3374830,375,190,79,150,90,60,79,Auction
3375249,675,320,249,150,115,35,74,Auction
3376466,2400,1605,550,805,465,340,-1050,Auction
3376636,325,105,114,30,10,20,-111,Auction
3377972,450,165,190,265,150,115,15,Auction
3378557,475,165,209,105,70,35,234,Auction
3378657,750,370,270,160,125,35,-305,Auction
3379310,1350,885,359,955,585,370,284,Auction
3357667,2500,1820,455,2070,1420,650,-245,Auction
3379893,225,25,90,35,15,20,65,Auction
3384390,1425,850,469,595,345,250,69,Auction
3385360,350,165,79,200,150,50,29,Auction
3386196,950,585,440,340,190,150,115,Auction
3386645,975,605,210,380,230,150,-190,Auction
3387532,850,400,274,335,285,50,-276,Auction
3387617,725,425,150,180,120,60,-485,Auction
3388383,1425,915,400,620,340,280,-575,Auction
3388783,425,120,199,75,50,25,24,Auction
3389321,350,120,100,80,60,20,75,Auction
3390208,800,465,225,410,190,220,25,Auction
3390657,475,230,135,85,65,20,-260,Auction
3392616,875,415,350,315,165,150,-75,Auction
2984284,1200,675,330,255,155,100,-869.5,Auction
2999010,900,430,360,135,75,60,-251,Auction
3035069,1025,545,370,265,165,100,67.5,Auction
3059487,725,350,215,80,55,25,16.25,Auction
3110959,1425,800,415,275,175,100,174.75,Auction
3132755,700,370,310,160,100,60,123,Auction
3186299,1100,565,425,215,115,100,-612.5,Auction
3210642,325,95,120,135,75,60,-32.75,Auction
3211260,1350,925,319,197,135,62,-481,Auction
3213332,350,100,140,115,80,35,-169.25,Auction
3222717,500,180,214,110,90,20,-170.75,Auction
3222449,325,125,79,125,65,60,-71,Auction
3236528,2000,1525,294,150,115,35,-1158,Auction
3241169,700,415,240,120,60,60,-177.75,Auction
3241140,525,245,174,150,100,50,411.75,Auction
3227022,975,580,230,455,345,110,210.5,Auction
3268841,575,280,189,345,195,150,-212.5,Auction
3269777,500,195,199,45,25,20,-201,Auction
3276415,1200,795,299,660,380,280,-651,Auction
3278512,850,505,190,650,370,280,67.75,Auction
3290820,1350,815,425,225,125,100,-817.25,Auction
3288105,3225,2405,714,1230,780,450,87.5,Auction
3282974,1150,665,379,515,265,250,-471,Auction
3303831,575,255,214,115,80,35,-261,Auction
3304017,350,105,139,75,55,20,39,Auction
3304699,375,155,155,100,65,35,-147.75,Auction
3306889,725,425,194,80,60,20,-231,Auction
3308736,2225,1630,390,1460,960,500,251,Auction
3319700,525,220,199,190,155,35,-130,Auction
3323219,400,170,124,170,135,35,78.78,Auction
3324930,800,500,150,180,160,20,-100,Auction
3327924,500,195,199,345,195,150,249,Auction
3328810,500,195,199,125,65,60,124,Auction
3330621,650,335,294,270,170,100,169,Auction
3331289,275,65,104,60,35,25,-21,Auction
3331843,725,320,299,240,140,100,-276,Auction
3336705,950,560,280,61,35,26,180,Auction
3331014,575,270,199,175,115,60,347.5,Auction
3338284,875,550,219,555,305,250,270.75,Auction
3338377,725,410,175,240,190,50,0,Auction
3338645,650,365,140,180,160,20,-350.5,Auction
3335787,600,270,224,160,100,60,474,Auction
3339595,575,270,195,140,80,60,212,Auction
3339038,550,235,204,125,90,35,-121,Auction
3342028,450,195,149,80,55,25,-178,Auction
3342764,325,105,114,110,50,60,39,Auction
3343918,575,295,174,245,195,50,131.25,Auction
3347483,900,475,315,280,180,100,207,Auction
3352256,550,245,199,160,125,35,4.21,Auction
3355600,300,60,134,115,80,35,34,Auction
3356750,625,345,170,140,120,20,-80,Auction
3356800,675,270,235,115,55,60,320.25,Auction
3357204,1150,775,265,275,225,50,-209.75,Auction
3357218,1025,670,195,190,155,35,-280,Auction
3365360,850,440,355,590,340,250,-195,Auction
3369704,1175,830,210,150,115,35,-473.25,Auction
3370061,725,375,244,140,80,60,-31,Auction
3371122,2200,1715,375,1500,1000,500,-775,Auction
3372062,1850,1195,549,855,515,340,281.75,Auction
3367982,1025,520,319,450,230,220,-206,Auction
3364106,400,150,114,225,125,100,89,Auction
3374741,750,355,419,220,120,100,-56,Auction
3375920,925,480,269,375,225,150,-306,Auction
3376345,525,245,174,160,125,35,-51,Auction
3377610,825,520,250,350,275,75,-150,Auction
3377685,550,285,150,260,160,100,-50,Auction
3378685,700,300,290,125,90,35,-240,Auction
3379889,375,140,129,150,115,35,296.8,Auction
3380107,1225,755,364,430,375,55,-461,Auction
3301759,725,390,204,280,180,100,279,Auction
3382354,550,270,174,200,100,100,197.5,Auction
3382804,1800,1240,454,1165,765,400,454,Auction
3368993,725,410,200,190,155,35,232.75,Auction
3382634,900,550,244,500,250,250,140,Auction
3334553,1200,760,334,550,300,250,734,Auction
3382936,1775,1395,274,575,325,250,274,Auction
3387416,500,190,200,210,160,50,-150,Auction
3384923,525,260,129,190,155,35,79,Auction
3388718,950,585,355,130,95,35,-485.63,Auction
3390090,575,260,200,85,60,25,-225,Auction
3390290,375,120,149,5,5,0,-151,Auction
3390843,250,55,79,100,40,60,329,Auction
3383970,400,140,120,115,80,35,-155,Auction
3391545,800,465,225,595,345,250,425,Auction
3390443,700,375,174,200,100,100,149,Auction
3391711,425,145,174,205,105,100,99,Auction
3392915,700,370,220,140,80,60,95,Auction
3393081,275,60,109,65,40,25,34,Auction
3367092,375,120,114,41,20,21,39,Auction
3393234,450,145,199,65,40,25,49,Auction
3393834,900,435,359,250,200,50,-341,Auction
3389907,1225,875,195,585,335,250,170,Auction
3386731,3450,2825,414,1590,1090,500,-1536,Auction
3394753,825,420,295,225,125,100,-155,Auction
3396659,875,590,179,275,225,50,204,Auction
3397195,900,550,194,80,55,25,644,Auction
3388803,350,105,119,110,50,60,119,Auction
3397944,550,260,175,165,115,50,440,Auction
3400016,825,435,280,295,195,100,155,Auction
3400118,675,340,229,20,10,10,205.25,Auction
3400335,475,170,199,185,125,60,74,Auction
3401071,300,85,105,200,150,50,126.37,Auction
3401203,1450,965,375,400,345,55,-150,Auction
3401505,825,465,319,65,40,25,319,Auction
3401539,575,220,245,235,185,50,-5,Auction
3401705,1200,760,334,275,175,100,34,Auction
3401437,350,135,105,165,105,60,55,Auction
3404445,400,180,90,180,160,20,40,Auction
3402356,650,365,175,80,55,25,100,Auction
3394285,550,265,174,195,135,60,374,Auction
3405432,375,130,140,125,65,60,115,Auction
3406351,825,550,169,275,225,50,-81,Auction
3407789,325,120,95,105,70,35,20,Auction
3395523,800,390,244,180,145,35,144,Auction
3406151,400,145,115,90,65,25,-185,Auction
3408691,1525,1080,339,995,625,370,514,Auction
3408925,1900,1270,520,345,195,150,1720,Auction
3408810,775,450,219,185,150,35,544,Auction
3410699,2075,1615,350,1560,1060,500,-175,Auction
3410899,350,135,109,125,65,60,109,Auction
3410916,375,150,119,150,90,60,269,Auction
3412052,575,250,210,135,75,60,10,Auction
3412503,275,60,94,25,5,20,19,Auction
3412601,1125,735,229,485,265,220,204,Auction
3413286,1000,625,220,540,290,250,120,Auction
3413520,975,650,219,180,160,20,119,Auction
3413890,775,450,219,320,170,150,294,Auction
3411316,400,190,119,150,90,60,119,Auction
3415677,425,145,234,55,35,20,184,Auction
3416162,3875,3305,464,1535,1035,500,1839,Auction
3417230,600,320,174,165,130,35,174,Auction
3416762,550,205,200,175,140,35,25,Auction
3417932,1100,565,425,475,255,220,225,Auction
3418519,375,150,140,5,5,0,-116.6,Auction
3418485,425,145,174,80,55,25,349,Auction
3420191,700,355,235,120,60,60,-115,Auction
3379668,750,370,270,275,225,50,295,Auction
3379435,250,65,79,60,35,25,79,Auction
3381140,875,525,240,530,280,250,415,Auction
3382979,800,405,289,200,150,50,239,Auction
3383093,400,185,94,145,85,60,186.8,Auction
3384548,750,430,210,160,125,35,-343.75,Auction
3385302,700,335,255,175,140,35,-195,Auction
3385569,400,150,144,155,120,35,-156,Auction
3386020,675,375,174,145,110,35,122.5,Auction
3387455,1825,1245,469,780,470,310,794,Auction
3390584,725,355,264,310,160,150,289,Auction
3390719,1500,980,330,20,10,10,630,Auction
3390851,700,355,265,200,150,50,-235,Auction
3391069,425,140,175,135,75,60,-125,Auction
3391588,500,245,149,280,245,35,124,Auction
3349869,625,300,219,159,125,34,-256,Auction
3392320,850,425,319,360,310,50,19,Auction
3392438,450,210,105,145,110,35,-145,Auction
3393523,1175,660,329,225,190,35,254,Auction
3393660,525,270,120,174,125,49,420,Auction
3394060,300,95,140,70,45,25,115,Auction
3394345,500,220,174,70,45,25,274,Auction
3395013,725,440,175,135,100,35,-530,Auction
3395464,600,315,175,155,120,35,100,Auction
3396532,375,150,90,205,105,100,-185,Auction
3360816,550,235,209,205,155,50,159,Auction
3395914,825,440,224,380,230,150,224,Auction
3387906,575,255,199,165,105,60,124,Auction
3387574,1700,1275,254,1210,760,450,-346,Auction
3388241,1050,710,205,155,95,60,305,Auction
3399757,275,60,109,75,50,25,134,Auction
3400025,375,190,99,200,150,50,195,Auction
3400693,400,165,125,70,50,20,100,Auction
3392673,700,395,174,340,190,150,24,Auction
3401130,350,130,165,55,30,25,65,Auction
3401144,1850,1225,470,1165,765,400,-880,Auction
3401212,1025,595,320,190,155,35,120,Auction
3401798,650,320,220,395,245,150,-155,Auction
3403066,1000,645,290,340,265,75,-260,Auction
3407164,850,530,214,360,285,75,364,Auction
3407414,2400,1730,564,1225,775,450,564,Auction
3407831,425,120,199,125,65,60,274,Auction
3408635,600,280,214,125,65,60,-161,Auction
3409168,675,335,219,265,215,50,194,Auction
3410954,500,180,199,75,50,25,-126,Auction
3411708,350,150,94,95,70,25,94,Auction
3411894,1175,790,259,390,340,50,259,Auction
3412844,575,295,165,165,105,60,15,Auction
3410571,500,190,200,315,165,150,450,Auction
3413197,550,235,209,325,175,150,-91,Auction
3413511,550,230,210,210,110,100,160,Auction
3414115,2225,1740,315,1000,600,400,640,Auction
3408768,550,260,175,280,230,50,150,Auction
3414966,550,245,199,125,90,35,-1,Auction
3415720,400,140,124,130,95,35,124,Auction
3415987,550,245,199,160,125,35,-151,Auction
3416055,500,220,174,185,125,60,149,Auction
3417473,1650,1190,350,715,405,310,-500,Auction
3418110,575,295,174,195,135,60,374,Auction
3418928,775,370,295,220,120,100,170,Auction
3418978,450,195,149,190,155,35,-1,Auction
3419596,575,290,155,180,120,60,80,Auction
3383562,400,140,124,120,60,60,199,Auction
3418442,1500,865,529,275,225,50,-571,Auction
3420718,525,205,210,145,85,60,110,Auction
3422221,675,315,250,110,90,20,-150,Auction
3422489,500,250,215,100,40,60,15,Auction
3422753,375,155,110,175,140,35,35,Auction
3424058,725,320,299,180,120,60,224,Auction
3382129,325,85,105,50,25,25,-95,Auction
3382454,375,135,134,85,60,25,459,Auction
3382840,975,645,220,250,200,50,-180,Auction
3383465,400,170,124,70,45,25,-76,Auction
3383751,275,75,85,6,5,1,-150,Auction
3384219,1225,820,299,500,250,250,-226,Auction
3385137,1075,680,289,300,225,75,814,Auction
3384887,1275,755,330,200,165,35,-570,Auction
3386691,1050,530,410,260,225,35,-290,Auction
3389258,2125,1365,630,650,370,280,-820,Auction
3389969,700,335,255,155,95,60,30,Auction
3391266,1475,1015,350,930,560,370,998,Auction
3391530,2300,1700,490,1085,685,400,-580,Auction
3392134,3125,2520,495,2325,1675,650,1570,Auction
3312269,1675,1295,410,855,515,340,35,Auction
3391373,500,195,199,215,165,50,-51,Auction
3394960,400,170,124,90,65,25,174,Auction
3387920,1000,500,314,75,50,25,-186,Auction
3398568,450,170,174,190,130,60,49,Auction
3398843,1500,860,840,655,375,280,340,Auction
3399261,625,335,179,15,5,10,-246,Auction
3400247,475,165,200,80,55,25,50,Auction
3397707,250,60,80,20,10,10,-45,Auction
3396435,375,185,80,170,135,35,-20,Auction
3397682,625,315,175,245,210,35,-250,Auction
3400801,575,290,175,300,250,50,0,Auction
3373573,950,495,294,105,45,60,394,Auction
3401651,900,430,360,290,190,100,60,Auction
3404327,600,165,240,205,115,90,-287,Auction
3403991,1525,1105,250,910,540,370,-125,Auction
3405545,300,75,114,80,60,20,-36,Auction
3405663,1125,680,339,110,50,60,414,Auction
3407131,1150,635,345,560,310,250,-105,Auction
3407174,1125,680,339,745,435,310,1214,Auction
3407399,1200,815,240,870,530,340,-685,Auction
3407735,300,75,115,35,15,20,-10,Auction
3409957,800,445,249,500,250,250,299,Auction
3410050,475,230,135,150,115,35,-140,Auction
3410493,850,440,300,205,105,100,225,Auction
3411986,350,160,80,115,55,60,180,Auction
3412483,250,65,79,100,40,60,79,Auction
3413458,925,480,269,225,175,50,-231,Auction
3407324,2625,1815,700,765,455,310,1125,Auction
3415305,2350,1755,489,775,465,310,239,Auction
3415616,1050,620,339,305,155,150,389,Auction
3415884,900,505,289,185,125,60,489,Auction
3416427,375,150,115,60,35,25,440,Auction
3417002,1175,620,355,365,215,150,-270,Auction
3417713,1500,860,530,810,470,340,230,Auction
3390569,1000,620,219,720,565,155,119,Auction
3418270,400,150,144,140,105,35,-56,Auction
3418688,650,330,210,240,140,100,335,Auction
3419385,350,110,130,95,70,25,80,Auction
3420703,400,215,79,150,115,35,129,Auction
3420896,350,115,100,150,115,35,-50,Auction
3364967,2050,1365,469,920,550,370,1419,Auction
3418581,1400,1065,180,865,525,340,230,Auction
3423179,1700,1190,404,515,265,250,879,Auction
3423554,400,115,175,80,60,20,-165,Auction
3423579,1175,625,444,230,180,50,451.75,Auction
3423647,1150,715,325,770,460,310,55,Auction
3425065,950,515,344,425,370,55,344,Auction
3425176,675,335,234,175,115,60,-266,Auction
3418767,600,265,200,95,75,20,-175,Auction
3426269,1075,605,360,390,315,75,-265,Auction
3426719,2150,1600,440,1295,845,450,440,Auction
3380948,1800,1185,505,1420,920,500,487.75,Auction
3382384,350,135,109,165,130,35,-16,Auction
3383235,775,465,200,530,280,250,25,Auction
3385277,1500,980,410,1425,925,500,-90,Auction
3386294,700,375,174,215,165,50,699,Auction
3387364,450,220,100,165,105,60,75,Auction
3387951,650,300,240,120,60,60,-60,Auction
3388115,775,385,280,400,180,220,197,Auction
3369029,1350,885,294,725,415,310,144,Auction
3389638,400,145,145,75,50,25,70,Auction
3383822,675,335,199,124,65,59,104.54,Auction
3363049,375,170,84,175,115,60,-41,Auction
3391946,325,105,90,140,105,35,90,Auction
3393382,700,355,235,80,60,20,167.25,Auction
3384558,350,130,90,155,95,60,-35,Auction
3391695,500,195,199,205,155,50,74,Auction
3370901,925,495,320,225,175,50,495,Auction
3394618,625,335,179,300,150,150,154,Auction
3395456,600,270,199,110,55,55,224,Auction
3395654,525,215,275,140,80,60,125,Auction
3396492,1075,740,225,425,205,220,200,Auction
3396690,350,165,79,75,50,25,179,Auction
3397628,1525,1110,249,995,625,370,-676,Auction
3398464,375,160,109,135,75,60,434,Auction
3398647,575,305,160,260,225,35,235,Auction
3400585,1600,1230,264,965,595,370,264,Auction
3399164,550,230,205,150,115,35,80,Auction
3402508,975,485,369,220,185,35,219,Auction
3402593,650,325,219,210,160,50,169,Auction
3403378,400,170,109,75,55,20,84,Auction
3403678,675,375,194,260,160,100,269,Auction
3376617,625,300,199,310,235,75,219.54,Auction
3404144,1225,840,365,515,390,125,65,Auction
3404278,350,150,94,20,10,10,-56,Auction
3390774,400,170,124,70,45,25,-176,Auction
3404663,1000,650,244,210,175,35,-456,Auction
3389774,1200,795,295,975,790,185,-5,Auction
3405852,925,565,215,640,360,280,332,Auction
3406350,600,265,200,170,120,50,225,Auction
3406552,350,125,119,135,100,35,269,Auction
3407707,1000,650,214,455,235,220,1314,Auction
3408309,725,320,299,200,150,50,-226,Auction
3410130,325,90,104,50,25,25,29,Auction
3410281,400,175,169,58,35,23,169,Auction
3411266,475,195,174,160,125,35,999,Auction
3412166,750,430,210,425,205,220,-415,Auction
3412651,2300,1820,299,1125,725,400,322.5,Auction
3414423,575,265,200,175,115,60,164,Auction
3414759,275,65,100,25,5,20,25,Auction
3399500,525,220,199,110,90,20,224,Auction
3416046,1575,1040,425,1400,900,500,550,Auction
3416748,775,450,219,645,365,280,219,Auction
3417531,1575,1155,480,870,530,340,-295,Auction
3417584,450,140,200,155,95,60,275,Auction
3418269,450,145,209,75,50,25,-166,Auction
3419105,300,95,80,300,150,150,5,Auction
3419356,2575,2080,385,650,370,280,1010,Auction
3419754,650,290,204,210,160,50,-71,Auction
3417818,850,480,210,465,245,220,310,Auction
3423183,1075,680,225,435,215,220,150,Auction
3424219,625,335,180,390,315,75,705,Auction
3424519,875,415,315,135,115,20,-135,Auction
3424785,950,465,379,450,230,220,129,Auction
3382030,675,390,179,295,245,50,-196,Auction
3383123,325,120,95,140,105,35,-30,Auction
3383591,350,100,115,90,65,25,-110,Auction
3384068,775,415,219,265,165,100,-356,Auction
3384302,725,425,165,355,205,150,-110,Auction
3373240,525,190,200,170,150,20,-100,Auction
3356919,475,205,150,215,175,40,-200,Auction
3387544,825,420,255,250,215,35,-445,Auction
3389550,2700,1970,504,1615,1065,550,1704,Auction
3389809,1000,675,215,120,100,20,-135,Auction
3390247,225,30,89,50,25,25,64,Auction
3390622,625,315,175,30,10,20,-364.55,Auction
3365918,1100,685,305,455,235,220,-320,Auction
3393689,2200,1810,284,640,570,70,-1076,Auction
3395970,700,410,184,200,100,100,184,Auction
3389843,775,415,250,215,115,100,425,Auction
3397165,2025,1585,330,1850,1250,600,255,Auction
3389286,775,345,255,155,120,35,-370,Auction
3398140,750,385,240,200,150,50,-110,Auction
3398710,800,510,184,100,65,35,-241,Auction
3399812,2650,2100,440,1550,1050,500,-710,Auction
3400446,925,445,370,265,165,100,245,Auction
3401275,475,170,199,80,55,25,824,Auction
3401650,975,560,245,695,415,280,195,Auction
3402343,700,370,295,170,135,35,-55,Auction
3402547,300,115,79,75,50,25,202.5,Auction
3396327,1225,655,350,600,350,250,675,Auction
3403815,700,420,174,500,250,250,124,Auction
3403990,2125,1580,439,1650,1100,550,1614,Auction
3394196,1050,670,219,130,70,60,-331,Auction
3406155,1625,1040,479,265,215,50,154,Auction
3406223,650,270,274,110,50,60,324,Auction
3385672,350,100,114,95,70,25,-111,Auction
3406725,575,295,174,245,195,50,149,Auction
3407032,375,150,169,15,5,10,169,Auction
3408627,1600,1210,280,865,525,340,-20,Auction
3408806,575,270,199,350,200,150,106.75,Auction
3408797,1300,880,310,170,110,60,-540,Auction
3409942,775,415,219,150,90,60,-256,Auction
3410201,450,145,199,95,70,25,849,Auction
3411580,750,385,255,355,205,150,-145,Auction
3412337,775,425,240,335,185,150,36.25,Auction
3412541,375,130,110,145,85,60,-15,Auction
3414086,875,485,229,135,75,60,229,Auction
3412405,275,60,89,65,40,25,-11,Auction
3415379,650,305,239,190,170,20,-286,Auction
3416051,800,440,254,375,225,150,54,Auction
3398135,450,200,115,170,135,35,165,Auction
3417187,550,235,204,110,50,60,154,Auction
3392928,375,175,80,225,175,50,105,Auction
3420268,475,220,149,235,185,50,149,Auction
3420697,400,170,124,175,140,35,149,Auction
3420995,275,85,80,70,45,25,-95,Auction
3414018,900,525,214,250,200,50,214,Auction
3412916,725,410,175,250,200,50,100,Auction
3406198,625,300,199,215,125,90,149,Auction
3422544,475,170,199,190,130,60,-76,Auction
3422901,725,445,174,215,115,100,1749,Auction
3423403,750,460,154,260,225,35,154,Auction
3423880,500,220,174,200,100,100,374,Auction
3424003,900,480,314,395,320,75,749,Auction
3424173,525,240,175,175,115,60,45.35,Auction
3371525,725,355,264,185,125,60,139,Auction
3382298,975,660,209,250,200,50,334,Auction
3425173,900,550,194,705,395,310,194,Auction
3385048,325,90,129,125,90,35,4,Auction
3385937,700,360,199,255,170,85,1899,Auction
3389697,1000,645,245,165,145,20,-155,Auction
3390083,750,415,225,235,135,100,275,Auction
3390283,2175,1695,324,1405,905,500,349,Auction
3390666,475,170,199,135,75,60,74,Auction
3392223,1625,1090,429,125,65,60,54,Auction
3393074,1000,625,265,645,365,280,-435,Auction
3393760,400,140,124,166,105,61,-26,Auction
3390466,325,110,105,145,85,60,-95,Auction
3382993,875,505,214,535,285,250,539,Auction
3365414,575,290,175,170,135,35,-228.75,Auction
3394763,400,185,85,140,105,35,35,Auction
3395346,300,70,120,25,5,20,-30,Auction
3395432,425,120,199,60,35,25,174,Auction
3396167,375,175,144,170,135,35,184,Auction
3396767,775,390,279,245,145,100,254,Auction
3389330,700,410,149,300,225,75,99,Auction
3398989,850,555,189,65,40,25,189,Auction
3399308,650,315,225,195,135,60,-50,Auction
3399307,1000,645,200,295,195,100,-25,Auction
3400094,525,270,145,125,65,60,-105,Auction
3400261,650,325,219,445,225,220,669,Auction
3400461,525,245,174,125,65,60,449,Auction
3401648,650,330,210,95,80,15,-15,Auction
3401698,900,555,235,290,190,100,-265,Auction
3401779,500,240,150,245,145,100,-175,Auction
3403652,500,240,150,220,170,50,125,Auction
3404069,575,270,199,145,85,60,24,Auction
3403520,375,150,94,150,90,60,69,Auction
3378917,1300,910,229,950,580,370,329,Auction
3406009,1250,900,190,590,340,250,-285,Auction
3408217,700,340,254,89,65,24,-221,Auction
3384448,275,60,89,65,40,25,14,Auction
3409068,375,150,119,135,100,35,44,Auction
3409285,450,145,199,190,155,35,49,Auction
3410353,800,485,165,155,95,60,-435,Auction
3412058,625,315,200,180,145,35,-125,Auction
3412543,550,270,174,190,155,35,99,Auction
3412880,800,420,270,130,70,60,120,Auction
3412961,325,110,105,115,80,35,-130,Auction
3413548,625,340,175,95,70,25,50,Auction
3413862,1525,955,370,905,535,370,1195,Auction
3415352,550,275,165,245,145,100,115,Auction
3379050,2275,1660,509,1295,845,450,734,Auction
3415905,325,95,124,155,95,60,49,Auction
3416020,400,145,149,120,60,60,99,Auction
3416287,575,250,215,70,50,20,-135,Auction
3417623,575,255,289,200,100,100,260,Auction
3418142,500,190,200,100,40,60,-125,Auction
3418963,550,265,175,260,210,50,75,Auction
3419845,675,370,195,200,150,50,145,Auction
3422436,800,465,225,345,195,150,-75,Auction
3422572,800,470,224,50,25,25,-176,Auction
3423325,1200,695,395,150,90,60,-130,Auction
3423589,450,140,200,145,110,35,100,Auction
3423925,900,590,200,380,230,150,-100,Auction
3424558,475,215,150,200,150,50,-100,Auction
3424508,300,90,100,10,5,5,-100,Auction
3426784,775,425,240,340,190,150,-10,Auction
3426983,1500,1090,304,1240,790,450,157.5,Auction
3375787,600,340,120,195,135,60,170,Auction
3383582,250,60,80,80,55,25,-49.65,Auction
3384754,350,100,140,120,60,60,40,Auction
3385145,275,90,79,75,50,25,-46,Auction
3352123,875,530,194,505,255,250,119,Auction
3387083,600,320,174,135,75,60,24,Auction
3376121,525,270,115,185,150,35,-260,Auction
3390536,1000,675,215,510,260,250,2465,Auction
3390427,675,320,199,470,250,220,-26,Auction
3391608,600,205,225,155,95,60,175,Auction
3391742,250,60,80,5,5,0,55,Auction
3393078,1225,845,274,815,475,340,274,Auction
3396488,200,15,79,35,15,20,54,Auction
3400089,575,250,215,205,155,50,-185,Auction
3402268,1175,715,354,930,560,370,79,Auction
3402397,1175,795,215,735,425,310,340,Auction
3402904,1550,1165,594,410,355,55,-256,Auction
3403074,725,415,204,270,170,100,204,Auction
3403733,275,75,79,15,5,10,-121,Auction
3404410,525,215,200,100,40,60,0,Auction
3401366,575,295,149,155,95,60,149,Auction
3403440,1225,820,239,225,135,90,289,Auction
3405103,575,250,215,215,165,50,90,Auction
3405605,625,335,180,160,125,35,-270,Auction
3406005,350,120,120,75,50,25,-5,Auction
3406239,350,115,129,85,60,25,104,Auction
3405276,625,335,180,250,200,50,5,Auction
3406548,325,105,110,135,100,35,-145,Auction
3406775,2150,1495,545,1130,730,400,345,Auction
3406848,325,115,104,50,25,25,-71,Auction
3407775,900,520,270,250,200,50,295,Auction
3408754,650,315,225,215,180,35,-25,Auction
3410783,450,140,200,100,40,60,50,Auction
3411128,500,190,200,80,60,20,225,Auction
3412164,1675,1000,569,460,240,220,-906,Auction
3412355,1100,620,370,480,260,220,220,Auction
3412755,425,195,100,185,150,35,25,Auction
3413293,675,370,195,150,115,35,120,Auction
3414136,700,385,290,210,175,35,215,Auction
3414236,375,130,120,75,55,20,195,Auction
3407118,375,135,105,105,45,60,1225.5,Auction
3402204,475,195,174,100,40,60,449,Auction
3414872,725,440,175,150,90,60,-350,Auction
3415165,950,510,265,420,200,220,315,Auction
3415699,1450,1040,240,180,145,35,-935,Auction
3414129,875,485,265,375,300,75,190,Auction
3415742,375,135,165,70,45,25,-91.6,Auction
3415765,300,90,104,125,65,60,229,Auction
3415865,875,545,220,520,270,250,245,Auction
3416165,600,325,165,150,115,35,115,Auction
3416208,1125,700,319,330,180,150,669,Auction
3418407,450,170,174,50,25,25,-1,Auction
3419450,475,190,175,180,145,35,425,Auction
3356567,825,425,294,285,185,100,19,Auction
3421481,1025,520,369,450,230,220,-6,Auction
3421688,875,585,149,180,160,20,399,Auction
3410728,375,135,105,35,15,20,-149.55,Auction
3422281,1250,775,365,535,285,250,515,Auction
3423587,600,315,175,200,150,50,182.75,Auction
3419709,850,470,274,275,225,50,-126,Auction
3423653,525,220,199,150,90,60,524,Auction
3423896,1600,1230,264,200,150,50,364,Auction
3424196,475,170,199,130,95,35,174,Auction
3424389,1100,710,280,125,90,35,-650,Auction
3425132,625,305,199,340,265,75,824,Auction
3425268,425,120,199,140,80,60,74,Auction
3425566,1325,795,420,375,225,150,-155,Auction
3333487,375,170,79,215,165,50,129,Auction
3372761,475,165,199,195,150,45,-126,Auction
3373004,350,115,125,100,65,35,150,Auction
3374565,500,195,199,35,15,20,-126,Auction
3375169,550,245,199,240,190,50,-51,Auction
3380015,500,215,175,140,80,60,50,Auction
3380849,425,145,174,95,70,25,149,Auction
3384100,700,395,194,270,170,100,194,Auction
3387108,400,140,120,95,70,25,-80,Auction
3388005,950,535,294,715,405,310,169,Auction
3388975,950,515,329,155,95,60,-421,Auction
3386499,325,95,124,130,70,60,74,Auction
3370153,1600,1095,315,910,595,315,215,Auction
3373438,1175,825,244,320,245,75,169,Auction
3398499,775,390,180,100,65,35,-395,Auction
3399044,575,280,185,225,175,50,35,Auction
3401150,400,170,100,125,90,35,25,Auction
3401277,650,355,189,355,205,150,193.01,Auction
3401541,700,395,199,135,100,35,399,Auction
3403115,575,265,200,85,60,25,125,Auction
3403413,550,220,200,170,135,35,-280,Auction
3403851,450,140,200,80,55,25,175,Auction
3403881,875,525,240,390,315,75,190,Auction
3404081,350,100,115,120,100,20,65,Auction
3403924,725,375,205,160,125,35,130,Auction
3401979,975,580,234,490,270,220,159,Auction
3407459,725,405,214,275,225,50,-136,Auction
3407859,825,460,255,500,375,125,330,Auction
3401350,350,125,94,165,105,60,-131,Auction
3409229,1575,1000,469,500,375,125,76.75,Auction
3409365,750,465,175,220,170,50,-200,Auction
3410335,625,330,189,250,200,50,-36,Auction
3412207,500,245,149,250,200,50,124,Auction
3412373,725,410,175,190,155,35,-275,Auction
3412446,750,330,250,95,70,25,-200,Auction
3412616,900,505,269,415,195,220,119,Auction
3413118,900,525,344,260,225,35,144,Auction
3336636,550,245,199,295,195,100,474,Auction
3414352,525,240,175,275,225,50,-175,Auction
3414645,725,315,240,160,125,35,115,Auction
3403690,1225,880,194,565,315,250,94,Auction
3415356,775,465,200,410,190,220,25,Auction
3415624,350,130,95,150,115,35,45,Auction
3417287,575,265,290,75,55,20,-110,Auction
3406264,825,505,179,275,225,50,104,Auction
3418389,350,165,79,200,150,50,129,Auction
3418700,550,260,180,240,140,100,80,Auction
3418691,1700,1185,405,450,230,220,255,Auction
3419632,475,190,175,185,150,35,-50,Auction
3419861,575,255,214,240,140,100,214,Auction
3414445,675,390,175,285,185,100,-200,Auction
3420129,1175,680,365,395,320,75,590,Auction
3420563,1300,815,375,1020,620,400,175,Auction
3419568,875,565,204,410,355,55,-171,Auction
3421431,950,465,375,225,190,35,475,Auction
3405719,375,90,175,80,60,20,475,Auction
3423303,850,525,170,230,190,40,302.75,Auction
3424482,825,545,170,235,185,50,45,Auction
3426009,650,350,175,60,35,25,150,Auction
3424516,850,480,210,220,170,50,710,Auction
3426311,575,280,189,270,220,50,164,Auction
3381405,1325,905,314,495,275,220,-461,Auction
3381555,1175,775,319,525,275,250,244,Auction
3373853,900,505,234,265,165,100,-291,Auction
3373903,375,150,90,230,130,100,-85,Auction
3382142,1350,820,424,650,370,280,374,Auction
3382491,350,100,140,125,90,35,-110,Auction
3383228,850,510,234,300,150,150,-266,Auction
3385585,525,240,175,190,130,60,-175,Auction
3385836,300,95,70,100,45,55,2.75,Auction
3385935,875,445,344,135,115,20,69,Auction
3386836,575,270,199,140,80,60,-26,Auction
3387358,600,315,175,185,125,60,-200,Auction
3387657,1375,875,315,875,535,340,40,Auction
3341665,1300,885,249,265,230,35,181.75,Auction
3389043,575,305,160,250,200,50,-115,Auction
3389144,1075,660,309,95,70,25,907.5,Auction
3389546,1325,925,290,585,335,250,-185,Auction
3390317,725,320,299,185,165,20,-301,Auction
3391303,2675,2165,404,1905,1305,600,229,Auction
3366030,3150,2565,380,1085,685,400,-223.75,Auction
3393189,425,120,199,110,50,60,174,Auction
3382827,1275,940,184,720,410,310,209,Auction
3396433,800,430,264,385,235,150,-186,Auction
3396883,350,135,105,65,40,25,-20,Auction
3397133,850,510,234,305,155,150,-116,Auction
3397419,1700,1185,405,980,610,370,-195,Auction
3399542,825,520,195,185,125,60,45,Auction
3399827,750,405,235,210,160,50,-215,Auction
3400928,300,75,104,100,65,35,-121,Auction
3352561,625,285,230,190,155,35,-145,Auction
3401264,600,280,210,45,25,20,-165,Auction
3401863,725,350,215,200,150,50,-60,Auction
3402649,400,160,109,55,30,25,41.75,Auction
3402850,1575,1040,425,300,250,50,-675,Auction
3403335,425,145,174,125,90,35,-101,Auction
3404286,1075,745,224,695,415,280,449,Auction
3404322,1475,960,409,190,170,20,209,Auction
3405858,2400,1920,374,1455,955,500,374,Auction
3406843,1300,780,329,520,270,250,54,Auction
3406944,275,85,80,60,35,25,-20,Auction
3407194,725,320,269,250,200,50,-106,Auction
3407294,675,400,165,280,180,100,-85,Auction
3388979,400,180,89,185,150,35,-186,Auction
3409152,625,285,204,240,140,100,-171,Auction
3409301,2150,1665,375,1450,950,500,-125,Auction
3410037,400,170,124,130,110,20,49,Auction
3410202,250,65,79,80,55,25,29,Auction
3410237,825,425,269,500,375,125,394,Auction
3410623,800,475,215,155,95,60,-35,Auction
3405357,1325,905,254,150,115,35,929,Auction
3411909,2200,1765,329,1410,910,500,1229,Auction
3328161,625,275,199,155,120,35,974,Auction
3413531,325,120,115,85,65,20,-160,Auction
3413581,500,195,199,175,115,60,249,Auction
3413596,800,445,195,295,245,50,-58.38,Auction
3414568,1000,545,345,840,500,340,313.5,Auction
3414832,325,125,84,150,100,50,234,Auction
3416003,375,130,155,60,35,25,80,Auction
3416004,325,90,129,60,35,25,129,Auction
3417240,525,245,174,155,120,35,199,Auction
3417626,950,590,254,350,200,150,104,Auction
3418111,1675,1210,355,145,110,35,980,Auction
3418776,725,425,150,380,305,75,150,Auction
3419562,1525,1075,340,109,50,59,215,Auction
3419698,1050,620,324,810,470,340,399,Auction
3417690,550,285,125,190,155,35,-200,Auction
3420533,400,145,145,165,130,35,-130,Auction
3421970,400,120,174,140,105,35,174,Auction
3422620,500,220,174,215,180,35,124,Auction
3372152,1400,925,310,625,345,280,-590,Auction
3372354,1825,1265,364,1265,815,450,-561,Auction
3372711,350,135,89,80,65,15,-111,Auction
3293772,275,85,84,85,65,20,59,Auction
3375496,600,285,205,155,95,60,-148.63,Auction
3375755,1825,1210,409,965,595,370,209,Auction
3365064,675,370,175,260,210,50,-268.75,Auction
3369346,500,220,174,170,150,20,-76,Auction
3379933,725,425,190,140,80,60,-335,Auction
3381671,600,280,214,240,190,50,14,Auction
3385715,650,350,190,175,140,35,-35,Auction
3372747,525,215,200,190,155,35,257.75,Auction
3387821,775,425,240,290,190,100,-160,Auction
3345437,600,280,214,140,80,60,339,Auction
3389702,725,375,240,35,15,20,-185,Auction
3390840,475,170,199,100,40,60,-76,Auction
3377234,575,270,199,275,225,50,-126,Auction
3391597,1400,895,395,1275,825,450,327.75,Auction
3392769,550,265,174,125,105,20,-251,Auction
3393205,450,210,105,45,25,20,-265,Auction
3394839,750,390,325,210,175,35,-300,Auction
3360813,400,130,134,110,50,60,-41,Auction
3395884,925,545,219,440,220,220,794,Auction
3397983,475,170,199,165,130,35,-26,Auction
3401393,725,370,249,285,235,50,549,Auction
3402770,375,130,120,110,55,55,170,Auction
3391238,800,365,294,210,170,40,-306,Auction
3405671,400,210,80,160,100,60,-195,Auction
3407786,350,85,155,105,70,35,30,Auction
3408352,525,245,174,235,135,100,574,Auction
3409388,325,115,104,135,75,60,-97.5,Auction
3409922,1025,570,349,265,215,50,174,Auction
3407550,975,630,239,660,380,280,664,Auction
3410251,550,245,199,335,185,150,449,Auction
3410560,1225,820,299,560,310,250,374,Auction
3410015,925,565,250,475,255,220,-175,Auction
3412989,725,465,125,265,180,85,325,Auction
3413123,1525,1005,414,1190,790,400,-11,Auction
3414502,725,325,230,80,55,25,80,Auction
3329234,475,160,205,115,55,60,-170,Auction
3414897,450,165,175,105,45,60,250,Auction
3415304,550,250,190,300,225,75,165,Auction
3416133,800,430,249,155,95,60,199,Auction
3417076,1075,605,294,50,25,25,469,Auction
3417310,1025,570,349,145,125,20,124,Auction
3418348,775,430,239,345,195,150,239,Auction
3418546,500,195,199,190,155,35,45,Auction
3341559,575,270,199,185,125,60,224,Auction
3414661,925,590,184,300,150,150,159,Auction
3422047,425,120,199,150,115,35,199,Auction
3422126,675,375,194,170,110,60,119,Auction
3422449,1825,1240,475,1405,905,500,1050,Auction
3422483,825,435,225,150,115,35,-325,Auction
3423185,450,165,175,85,60,25,-128.63,Auction
3423228,1150,660,380,530,280,250,-74.65,Auction
3424028,350,70,174,65,45,20,-101,Auction
3424062,425,120,199,50,30,20,-26,Auction
3424857,650,355,189,380,230,150,414,Auction
3425527,675,335,230,135,75,60,-174.65,Auction
3379551,325,85,110,60,35,25,-40,Auction
3380452,975,580,289,635,495,140,210,Auction
3380673,475,215,150,75,50,25,25,Auction
3376508,725,355,214,365,215,150,164,Auction
3382410,2350,1750,490,1065,665,400,490,Auction
3382659,725,355,229,170,135,35,-196,Auction
3383095,850,480,260,550,300,250,10,Auction
3383496,650,370,174,265,215,50,920,Auction
3383581,750,430,210,275,175,100,260,Auction
3384096,950,515,344,190,155,35,-306,Auction
3384681,325,120,95,160,125,35,102.75,Auction
3386154,600,315,175,85,60,25,-50,Auction
3341161,375,155,110,150,90,60,-160,Auction
3386990,1800,1365,325,1365,915,450,307.75,Auction
3388761,925,545,274,620,340,280,324,Auction
3389263,350,115,104,115,55,60,-72.5,Auction
3391421,400,175,110,170,110,60,-90,Auction
3391585,425,170,115,105,45,60,-110,Auction
3391772,1425,915,400,1015,615,400,-275,Auction
3392036,650,270,274,160,140,20,-76,Auction
3392071,425,195,120,135,100,35,570,Auction
3392171,350,115,104,100,40,60,4,Auction
3392457,400,150,144,135,115,20,-31,Auction
3395129,625,295,200,100,65,35,-325,Auction
3395580,325,95,105,55,30,25,-45,Auction
3396130,550,265,175,180,120,60,325,Auction
3397337,925,525,294,670,390,280,165,Auction
3395765,475,170,199,140,80,60,199,Auction
3397688,1175,770,295,150,115,35,870,Auction
3398288,525,245,179,125,90,35,-146,Auction
3398574,900,590,200,190,155,35,-375,Auction
3398938,825,505,234,580,330,250,109,Auction
3399523,1150,600,440,475,255,220,-410,Auction
3399759,825,550,169,440,220,220,229,Auction
3400545,550,270,174,135,80,55,-226,Auction
3402481,1225,690,340,565,315,250,-85,Auction
3403103,750,445,195,95,70,25,-230,Auction
3403467,275,75,90,10,5,5,-64.55,Auction
3403753,650,335,199,355,205,150,199,Auction
3404303,400,145,144,175,140,35,-81,Auction
3404354,1775,1345,259,550,425,125,-516,Auction
3403868,250,60,80,100,40,60,30,Auction
3406125,450,170,174,203,155,48,149,Auction
3406211,400,120,164,150,115,35,-36,Auction
3406475,850,505,235,350,200,150,85,Auction
3406061,1400,825,465,750,440,310,-285,Auction
3407262,675,340,194,310,235,75,169,Auction
3407762,275,85,80,105,70,35,55,Auction
3408097,350,90,124,85,65,20,-126,Auction
3408383,650,325,219,500,250,250,315,Auction
3404103,375,155,90,125,90,35,-85,Auction
3406662,725,415,174,220,120,100,174,Auction
3409955,375,170,99,170,135,35,349,Auction
3411991,425,145,174,150,115,35,-26,Auction
3412828,600,320,174,190,130,60,270,Auction
3412878,600,280,214,215,165,50,106.8,Auction
3413428,600,320,174,415,305,110,174,Auction
3414300,800,500,190,420,200,220,-385,Auction
3415235,2725,2290,325,2015,1365,650,-1200,Auction
3415486,625,335,180,220,170,50,30,Auction
3415885,550,270,174,135,75,60,-151,Auction
3415886,2275,1790,350,1250,800,450,225,Auction
3418729,750,430,175,595,345,250,200,Auction
3419394,600,270,219,285,185,100,244,Auction
3420230,500,175,200,200,150,50,425,Auction
3413763,650,335,204,290,190,100,154,Auction
3421787,300,90,104,125,90,35,179,Auction
3422052,825,420,196.25,145,110,35,421.25,Auction
3393014,675,315,200,160,125,35,-25,Auction
3393050,350,145,80,140,120,20,122,Auction
3393265,550,230,210,125,65,60,185,Auction
3393701,1925,1525,290,855,515,340,15,Auction
3367040,1200,700,394,555,305,250,319,Auction
3385209,975,560,249,575,325,250,-76,Auction
3374294,900,475,250,195,135,60,-375,Auction
3394988,1575,1075,390,160,125,35,-610,Auction
3395373,1200,735,319,875,535,340,342.5,Auction
3395688,500,190,210,150,90,60,210,Auction
3396343,875,500,215,745,435,310,65,Auction
3396458,725,350,265,270,220,50,-370,Auction
3399817,600,340,150,200,150,50,-275,Auction
3400451,950,545,299,470,360,110,299,Auction
3401740,375,165,85,150,115,35,201.75,Auction
3401925,375,130,135,90,65,25,110,Auction
3402859,275,80,84,75,50,25,59,Auction
3398345,2825,2235,484,1720,1170,550,409,Auction
3403259,525,265,150,380,230,150,100,Auction
3403395,725,425,194,150,115,35,119,Auction
3403776,550,240,200,325,175,150,50,Auction
3404395,600,265,230,75,55,20,-224.65,Auction
3404897,775,430,239,175,155,20,189,Auction
3406133,450,165,175,35,15,20,125,Auction
3406167,350,100,114,125,90,35,89,Auction
3391929,475,190,180,160,125,35,-95,Auction
3396443,400,165,100,130,70,60,-25,Auction
3408439,825,480,235,330,255,75,60,Auction
3407790,700,325,269,155,120,35,69,Auction
3409228,525,240,175,230,130,100,410,Auction
3410598,825,380,335,615,335,280,35,Auction
3411249,550,245,199,200,150,50,145,Auction
3411300,3775,3100,569,1630,1080,550,619,Auction
3411634,1200,675,415,725,415,310,265,Auction
3411649,525,245,174,185,150,35,-151,Auction
3412736,625,250,215,230,180,50,-160,Auction
3413521,1300,715,479,895,555,340,54,Auction
3413570,325,75,144,90,65,25,119,Auction
3414072,325,135,80,75,50,25,80,Auction
3415227,375,130,114,50,25,25,164,Auction
3416229,400,140,139,160,140,20,39,Auction
3416865,200,10,80,25,5,20,-60,Auction
3418099,575,255,214,320,245,75,139,Auction
3419052,925,525,319,575,325,250,244,Auction
3419086,700,350,244,260,225,35,44,Auction
3419222,400,210,80,190,130,60,-20,Auction
3420743,600,285,205,200,100,100,-120,Auction
3421745,875,485,269,710,400,310,494,Auction
3421860,5325,4420,799,720,410,310,624,Auction
3394237,725,440,175,50,25,25,-460,Auction
3422294,625,345,135,100,40,60,-190,Auction
3422394,1225,720,399,600,320,280,-326,Auction
3367512,1675,1000,499,150,90,60,324,Auction
3422630,1800,1150,594,1275,825,450,694,Auction
3419137,400,145,149,160,140,20,-1,Auction
3423132,1425,800,515,405,185,220,140,Auction
3423415,900,455,335,120,60,60,-190,Auction
3413055,675,355,214,145,85,60,39,Auction
3423566,1100,655,355,295,195,100,80,Auction
3424268,1250,835,305,695,415,280,255,Auction
3425402,500,220,174,140,80,60,99,Auction
3425938,475,190,175,70,45,25,300,Auction
3421943,1725,1345,215,615,335,280,490,Auction
3386932,450,170,174,160,100,60,99,Auction
3388097,1375,945,324,1085,685,400,74,Auction
3388747,375,120,145,110,50,60,-80,Auction
3389635,275,75,94,110,50,60,-6,Auction
3384117,1825,1390,264,1435,935,500,939,Auction
3392000,1350,925,319,170,110,60,1669,Auction
3392150,650,270,274,220,170,50,-193.25,Auction
3393093,550,270,174,170,135,35,149,Auction
3393479,400,215,79,85,60,25,-221,Auction
3354137,925,545,274,535,285,250,349,Auction
3393629,1775,1325,344,1310,860,450,69,Auction
3394065,775,450,279,185,165,20,-696,Auction
3394851,400,155,60,160,125,35,60,Auction
3395008,300,80,90,69,50,19,-60,Auction
3393529,1925,1200,619,625,345,280,-6,Auction
3397216,675,315,250,175,115,60,0,Auction
3398809,900,595,174,135,100,35,264.25,Auction
3395694,350,100,140,80,60,20,40,Auction
3401167,850,480,260,440,220,220,537.95,Auction
3401174,1250,665,405,800,460,340,172.35,Auction
3401310,425,120,199,125,65,60,-51,Auction
3402003,1025,700,180,695,415,280,555,Auction
3403082,300,80,90,125,65,60,115,Auction
3401653,375,155,95,109,75,34,-80,Auction
3403675,1025,670,249,270,170,100,-176,Auction
3403932,725,355,264,135,115,20,264,Auction
3404225,350,90,129,55,30,25,-96,Auction
3405018,700,305,289,195,160,35,164,Auction
3405447,1675,1210,355,645,365,280,730,Auction
3405747,900,550,194,455,235,220,169,Auction
3405997,1200,735,355,155,120,35,-395,Auction
3406990,400,135,155,89,70,19,30,Auction
3394515,550,220,200,165,130,35,-50,Auction
3406147,1000,650,194,750,440,310,894,Auction
3408619,750,405,235,225,175,50,56.62,Auction
3410141,1400,900,394,755,445,310,394,Auction
3410234,625,345,170,175,155,20,45,Auction
3406583,250,45,94,5,5,0,144,Auction
3411913,650,315,229,355,205,150,579,Auction
3412020,1275,760,409,755,445,310,234,Auction
3413235,575,265,204,340,190,150,429,Auction
3413285,375,135,120,140,105,35,-5,Auction
3413685,875,460,294,300,150,150,294,Auction
3413785,700,390,200,180,120,60,-100,Auction
3414078,275,60,99,115,55,60,99,Auction
3412842,525,240,174,160,140,20,224,Auction
3409398,1875,1530,235,895,555,340,-290,Auction
3415028,275,75,90,123,65,58,65,Auction
3415457,1100,570,424,805,465,340,24,Auction
3417243,600,260,199,160,140,20,74,Auction
3417672,300,100,79,75,50,25,79,Auction
3417972,375,160,89,150,115,35,89,Auction
3345027,600,270,199,180,145,35,49,Auction
3419201,725,385,265,160,125,35,90,Auction
3400981,650,350,194,260,225,35,194,Auction
3421037,2600,2000,494,1400,900,500,501.75,Auction
3422609,875,460,289,280,180,100,239,Auction
3423502,775,350,269,225,175,50,269,Auction
3425067,525,220,199,270,185,85,74,Auction
3421773,725,425,190,130,70,60,140,Auction
3421437,1050,635,245,400,180,220,645,Auction
3426260,475,190,175,160,140,20,-50,Auction
3386364,475,170,199,115,55,60,249,Auction
3387300,750,410,234,510,260,250,1916.25,Auction
3387593,350,125,94,89,70,19,44,Auction
3387629,650,315,225,380,230,150,97.25,Auction
3379648,375,135,105,160,125,35,205,Auction
3388829,400,215,79,55,30,25,79,Auction
3390989,450,145,199,60,35,25,174,Auction
3391375,750,430,210,215,115,100,60,Auction
3391582,425,115,200,75,55,20,-100,Auction
3392611,275,85,80,50,30,20,-20,Auction
3396848,425,140,175,45,25,20,-100,Auction
3396912,325,120,80,60,35,25,-70,Auction
3392968,950,585,205,220,120,100,-379.75,Auction
3355248,500,195,199,15,5,10,49,Auction
3397555,725,375,205,185,135,50,-173.63,Auction
3398241,1150,685,359,550,300,250,509,Auction
3372796,1425,875,354,680,400,280,629,Auction
3399820,775,430,239,400,290,110,-36,Auction
3383199,725,315,240,185,150,35,-285,Auction
3379362,1050,585,355,555,305,250,105,Auction
3400649,375,120,119,110,50,60,94,Auction
3402171,2225,1785,334,1810,1210,600,-91,Auction
3402614,875,460,249,215,165,50,416.8,Auction
3402957,275,70,95,105,45,60,-5,Auction
3403107,875,505,264,240,140,100,389,Auction
3403321,550,260,170,150,100,50,45,Auction
3404443,1225,815,300,745,435,310,-150,Auction
3404600,325,135,80,145,110,35,-20,Auction
3404979,400,180,110,170,110,60,-40,Auction
3406115,700,335,255,335,185,150,155,Auction
3406715,975,565,255,535,315,220,-120,Auction
3407808,1625,1035,480,1235,785,450,105,Auction
3408144,2175,1670,395,1590,1090,500,270,Auction
3408594,375,100,165,76,50,26,-130,Auction
3409516,275,60,109,20,10,10,-91,Auction
3405036,650,265,240,195,135,60,15,Auction
3411988,3125,2550,429,810,470,340,329,Auction
3412131,1025,565,350,155,95,60,350,Auction
3413167,950,625,170,675,395,280,-105,Auction
3398098,1750,1215,429,1105,705,400,1279,Auction
3414403,575,250,200,200,150,50,225,Auction
3415232,400,160,219,10,5,5,69,Auction
3415289,650,315,200,240,140,100,850,Auction
3419083,525,245,174,240,140,100,124,Auction
3419583,525,220,199,195,135,60,174,Auction
3422134,275,65,100,35,15,20,75,Auction
3423177,525,240,175,104,45,59,-228.63,Auction
3424370,625,325,194,140,80,60,119,Auction
3425256,625,335,184,125,65,60,159,Auction
3425942,575,260,205,210,160,50,-20,Auction
3426042,1875,1310,439,315,165,150,1164,Auction
3399913,1600,1015,380,210,175,35,-620,Auction
3426228,2425,1875,444,1120,720,400,1019,Auction
3426321,850,410,261.25,100,65,35,136.25,Auction
3426421,450,210,190,250,200,50,190,Auction
3428393,1125,730,285,35,15,20,-230.63,Auction
3428457,1100,755,330,140,120,20,530,Auction
3427457,750,405,235,540,290,250,385,Auction
3426371,2550,1870,455,1665,1115,550,155,Auction
3430529,825,505,210,370,220,150,-65,Auction
3431615,1500,1085,305,195,135,60,455,Auction
3432501,1075,640,329,600,320,280,1354,Auction
3433666,375,185,80,80,60,20,-120,Auction
3383301,300,85,109,110,75,35,209,Auction
3384251,850,505,190,525,300,225,240,Auction
3376338,1175,620,355,230,195,35,-470,Auction
3385169,250,65,79,65,40,25,229,Auction
3386241,700,370,220,190,155,35,-205,Auction
3389583,375,105,129,125,90,35,-96,Auction
3389826,375,135,130,130,70,60,55,Auction
3390230,3400,2780,510,1300,850,450,-140,Auction
3371201,1925,1295,520,1250,800,450,177.25,Auction
3390787,400,145,119,75,55,20,119,Auction
3390923,400,190,84,165,105,60,234,Auction
3391541,650,270,244,190,155,35,-156,Auction
3392477,350,150,90,60,35,25,-114.55,Auction
3390405,750,390,215,285,235,50,65,Auction
3393345,1000,600,294,605,325,280,319,Auction
3395792,900,565,180,520,270,250,-370,Auction
3394867,1000,670,179,410,355,55,-121,Auction
3397982,550,270,174,220,170,50,-76,Auction
3398025,675,395,174,95,70,25,199,Auction
3399011,1100,680,314,430,210,220,114,Auction
3399829,2900,2080,579,1595,1095,500,1979,Auction
3399872,725,440,175,180,120,60,-175,Auction
3401140,675,285,280,155,120,35,-305,Auction
3402237,250,50,79,65,40,25,204,Auction
3402544,650,305,199,135,100,35,199,Auction
3403998,350,115,125,65,45,20,-29.65,Auction
3404016,1125,735,284,150,115,35,-241,Auction
3404466,825,485,230,420,200,220,605,Auction
3405084,600,320,174,275,225,50,99,Auction
3405070,300,90,84,125,90,35,509,Auction
3405538,1800,1240,450,230,180,50,-500,Auction
3406045,500,195,199,108,75,33,299,Auction
3406088,625,315,200,160,125,35,-225,Auction
3407542,825,505,210,405,295,110,160,Auction
3387595,1725,1295,259,935,565,370,134,Auction
3409839,1275,795,374,625,345,280,924,Auction
3409964,650,300,315,135,100,35,-10,Auction
3410393,850,470,274,410,190,220,149,Auction
3410418,575,250,215,260,210,50,-185,Auction
3410568,625,250,265,250,200,50,-60,Auction
3411354,600,295,199,135,75,60,74,Auction
3392102,1550,1100,270,575,325,250,-80,Auction
3411954,700,350,240,245,195,50,465,Auction
3412797,600,295,175,250,150,100,75,Auction
3398986,350,130,94,140,105,35,94,Auction
3384544,300,90,84,115,80,35,-166,Auction
3413065,500,190,200,80,55,25,-75,Auction
3413912,700,300,290,220,170,50,-110,Auction
3413962,625,255,264,125,65,60,373,Auction
3414069,1075,555,414,765,455,310,414,Auction
3415255,325,130,85,150,115,35,60,Auction
3415723,875,525,200,390,240,150,-250,Auction
3415780,375,150,115,150,115,35,-10,Auction
3416209,375,140,114,135,115,20,214,Auction
3416527,775,345,320,200,150,50,120,Auction
3401994,1275,855,250,135,100,35,225,Auction
3415516,700,375,174,150,115,35,1349,Auction
3417663,425,120,199,90,65,25,24,Auction
3418038,800,485,209,240,140,100,159,Auction
3418320,400,140,154,175,115,60,554,Auction
3418413,450,210,130,170,135,35,51.25,Auction
3418924,2250,1800,340,455,235,220,190,Auction
3389671,1550,1210,189,370,240,130,214,Auction
3390977,400,170,124,165,105,60,174,Auction
3392398,600,235,255,210,160,50,-95,Auction
3393300,725,320,299,175,115,60,-76,Auction
3393836,375,170,99,215,165,50,-135.75,Auction
3393934,750,430,300,210,110,100,175,Auction
3394036,525,270,200,175,115,60,-204.55,Auction
3377386,400,135,125,130,110,20,-225,Auction
3394487,900,550,244,375,225,150,44,Auction
3395087,475,165,204,150,115,35,4,Auction
3395287,700,335,365,210,160,50,-85,Auction
3396240,1175,800,269,445,225,220,269,Auction
3398014,3075,2505,460,985,615,370,-865,Auction
3390858,900,570,179,315,165,150,229,Auction
3401137,825,485,230,325,175,150,755,Auction
3402473,3250,2430,714,2275,1625,650,164,Auction
3402541,400,155,110,123,90,33,-190,Auction
3402660,525,240,175,140,80,60,-175,Auction
3403962,775,425,240,250,150,100,-160,Auction
3401605,375,150,90,145,125,20,-160,Auction
3407319,500,195,199,180,120,60,172.5,Auction
3407387,350,100,115,135,100,35,-165,Auction
3407757,1375,930,335,755,445,310,-665,Auction
3407940,975,625,240,600,320,280,15,Auction
3408225,475,170,199,210,110,100,624,Auction
3393500,500,195,199,70,45,25,199,Auction
3392730,875,565,164,435,215,220,89,Auction
3409191,300,100,90,20,10,10,140,Auction
3409242,475,190,175,70,45,25,-50,Auction
3409561,2225,1785,269,135,100,35,324,Auction
3406451,825,385,334,185,150,35,284,Auction
3410246,375,170,99,120,60,60,74,Auction
3411884,1200,820,219,435,215,220,169,Auction
3412050,1450,965,540,360,310,50,1840,Auction
3412420,600,295,175,165,105,60,75,Auction
3412535,925,570,249,175,115,60,250.71,Auction
3412786,400,185,160,65,40,25,-143.63,Auction
3414743,750,330,310,145,125,20,-215,Auction
3415309,475,195,174,190,130,60,174,Auction
3416160,325,95,100,75,50,25,50,Auction
3416330,625,320,199,155,120,35,124,Auction
3416628,400,160,134,95,75,20,34,Auction
3416679,850,460,229,320,170,150,244,Auction
3417432,750,430,214,175,115,60,203,Auction
3418419,975,580,289,360,210,150,514,Auction
3418551,400,135,200,135,100,35,75,Auction
3418938,675,350,219,180,160,20,219,Auction
3333866,775,450,179,255,155,100,404,Auction
3420108,1200,700,339,670,390,280,339,Auction
3407438,675,340,204,200,100,100,529,Auction
3420576,1100,660,439,150,115,35,-461,Auction
3353590,400,170,124,160,140,20,124,Auction
3421776,750,410,234,425,315,110,184,Auction
3422929,975,535,419,140,105,35,2144,Auction
3422963,775,465,200,250,200,50,-250,Auction
3416547,900,525,269,320,170,150,144,Auction
3423082,725,370,214,240,155,85,139,Auction
3423631,1250,675,465,360,285,75,-85,Auction
3424133,650,370,174,75,50,25,224,Auction
3424584,1550,1130,310,300,225,75,160,Auction
3417632,500,220,174,86,60,26,174,Auction
3426422,600,280,210,290,190,100,-165,Auction
3420459,875,550,219,385,235,150,219,Auction
3420557,700,395,195,485,265,220,-130,Auction
3421008,750,410,234,340,190,150,234,Auction
3422127,850,530,214,280,180,100,114,Auction
3420038,700,350,244,185,125,60,194,Auction
3423148,725,340,279,135,75,60,1654,Auction
3423182,775,375,234,182,145,37,234,Auction
3425505,650,345,199,180,160,20,249,Auction
3414541,525,245,174,130,95,35,149,Auction
3426458,600,295,195,175,155,20,-180,Auction
3427326,325,115,100,70,45,25,-100,Auction
3429015,575,265,199,190,145,45,349,Auction
3423063,1600,940,444,145,110,35,569,Auction
3431470,650,300,210,125,70,55,560,Auction
3424871,525,195,224,150,90,60,549,Auction
3432542,1325,840,304,150,100,50,679,Auction
3433091,450,190,150,105,45,60,325,Auction
3429062,725,355,264,155,135,20,264,Auction
3428896,3250,2530,440,700,390,310,190,Auction
3434414,475,190,175,155,95,60,-125,Auction
3435197,475,195,174,160,125,35,174,Auction
3436299,825,450,219,525,275,250,244,Auction
3436550,725,315,300,130,95,35,75,Auction
3393817,850,505,155,225,125,100,155,Auction
3409644,1025,670,195,295,195,100,70,Auction
3438005,825,445,270,325,275,50,345,Auction
3438358,750,370,239,150,115,35,139,Auction
3439073,650,300,240,195,135,60,140,Auction
3439860,825,520,195,260,210,50,-30,Auction
3439158,650,365,175,330,180,150,450,Auction
3440762,475,165,200,85,60,25,100,Auction
3440243,650,290,204,180,160,20,54,Auction
3429683,875,530,194,130,95,35,194,Auction
3441532,600,285,205,50,25,25,55,Auction
3442383,475,195,174,100,40,60,299,Auction
3443553,950,540,240,50,25,25,690,Auction
3443838,275,115,50,10,5,5,0,Auction
3443872,875,475,290,405,185,220,240,Auction
3445527,1050,610,334,155,120,35,334,Auction
3446110,750,330,310,150,115,35,60,Auction
3424144,525,215,200,250,150,100,200,Auction
3425212,1275,855,310,220,170,50,835,Auction
3425812,700,405,150,210,160,50,50,Auction
3426080,650,315,229,190,155,35,179,Auction
3425611,600,270,199,195,135,60,99,Auction
3426948,425,140,175,175,140,35,225,Auction
3427216,725,425,150,300,245,55,-350,Auction
3418877,1075,705,234,410,355,55,134,Auction
3428569,1225,780,274,465,245,220,124,Auction
3428637,650,355,189,225,175,50,-211,Auction
3428705,775,385,225,290,190,100,-300,Auction
3429406,2775,2230,435,1965,1365,600,1192.75,Auction
3430027,625,325,190,275,225,50,165,Auction
3425544,775,350,254,540,290,250,-321,Auction
3392106,2475,1870,495,1510,1010,500,520,Auction
3433100,425,115,200,110,50,60,50,Auction
3433282,750,395,249,490,270,220,-1,Auction
3434036,450,165,175,140,80,60,71.25,Auction
3434321,925,570,249,315,165,150,924,Auction
3434771,4925,4080,739,165,105,60,789,Auction
3434904,1100,660,269,570,320,250,-181,Auction
3435121,550,210,214,85,60,25,314,Auction
3435840,600,315,175,220,180,40,-150,Auction
3437162,725,415,204,320,170,150,329,Auction
3426015,775,450,175,200,150,50,600,Auction
3437380,375,90,175,60,35,25,45.35,Auction
3438247,1400,785,509,490,270,220,-366,Auction
3438397,800,470,224,300,150,150,324,Auction
3437444,700,410,184,350,200,150,534,Auction
3438665,1000,580,314,230,130,100,414,Auction
3439469,1075,635,265,305,155,150,140,Auction
3439601,975,605,260,335,185,150,235,Auction
3439651,3575,2930,494,1615,1065,550,2064,Auction
3439652,1425,990,329,195,135,60,504,Auction
3439669,675,340,229,135,100,35,129,Auction
3439787,575,265,200,215,165,50,-200,Auction
3440137,875,545,415,365,215,150,140,Auction
3440855,675,320,219,190,155,35,194,Auction
3441706,675,360,219,250,200,50,294,Auction
3442242,850,440,240,325,250,75,315,Auction
3442460,975,630,239,350,275,75,364,Auction
3443209,575,265,204,330,180,150,229,Auction
3428955,5650,4695,849,1290,840,450,849,Auction
3445132,550,260,180,205,155,50,305,Auction
3445267,300,145,49,160,140,20,124,Auction
3445318,700,435,159,375,300,75,159,Auction
3445600,1025,695,224,430,375,55,699,Auction
3445936,1275,755,750,275,225,50,271.62,Auction
3446067,700,375,284,220,185,35,284,Auction
3446071,650,335,179,315,240,75,529,Auction
3447021,2525,2150,210,2115,1465,650,985,Auction
3447139,500,240,150,250,200,50,-175,Auction
3447190,625,360,159,390,315,75,184,Auction
3447421,750,370,274,210,160,50,-176,Auction
3446812,1550,1040,344,1130,730,400,194,Auction
3448250,650,305,239,95,70,25,262.5,Auction
3359906,550,220,200,175,140,35,250,Auction
3437686,600,315,115,105,45,60,190,Auction
3451075,1600,1020,439,710,400,310,729.25,Auction
3451543,600,280,210,85,60,25,-190,Auction
3381383,400,215,79,120,60,60,79,Auction
3453815,700,350,240,150,90,60,390,Auction
3453781,600,325,169,200,165,35,-131,Auction
3454232,700,370,220,280,230,50,20,Auction
3454385,1300,750,440,685,405,280,540,Auction
3455236,775,450,215,220,170,50,215,Auction
3456087,525,215,200,110,50,60,120.35,Auction
3456104,1100,645,349,225,125,100,249,Auction
3444170,450,145,199,60,35,25,199,Auction
3456423,2025,1380,535,310,235,75,660,Auction
3457006,2175,1690,375,400,345,55,400,Auction
3457108,500,195,199,185,150,35,-1,Auction
3459061,650,315,229,145,125,20,329,Auction
3459797,1200,695,395,1005,605,400,395,Auction
3460567,800,405,230,245,195,50,205,Auction
3461435,800,405,234,140,120,20,234,Auction
3461537,750,400,244,240,205,35,344,Auction
3427966,475,170,199,105,70,35,524,Auction
3429320,750,385,255,290,190,100,105,Auction
3429613,650,355,189,175,115,60,-161,Auction
3417220,725,385,189,140,80,60,264,Auction
3430456,725,355,264,305,230,75,-161,Auction
3430731,550,205,285,90,65,25,610,Auction
3432217,675,335,199,210,160,50,324,Auction
3432460,750,430,175,280,180,100,25,Auction
3432796,725,425,175,195,135,60,1100,Auction
3396746,925,525,259,405,185,220,134,Auction
3433353,375,65,200,50,25,25,125,Auction
3433514,3025,2460,455,650,370,280,-1470,Auction
3426869,3775,3100,450,2000,1350,650,1875,Auction
3426468,850,465,220,415,305,110,145,Auction
3411211,825,425,234,420,200,220,259,Auction
3434518,600,290,204,125,105,20,104,Auction
3434800,625,340,175,165,105,60,-125,Auction
3422232,750,400,194,430,320,110,244,Auction
3435225,550,230,210,145,110,35,-115,Auction
3435361,675,390,215,165,130,35,15,Auction
3435075,850,465,275,345,270,75,-175,Auction
3436072,550,235,209,185,150,35,-16,Auction
3436054,1300,910,424,1075,675,400,2624,Auction
3436204,750,385,255,435,215,220,945,Auction
3436472,700,370,220,245,210,35,520,Auction
3436540,825,485,230,85,65,20,-170,Auction
3436833,3600,3060,430,1125,725,400,1380,Auction
3436897,600,320,174,90,65,25,74,Auction
3437526,500,195,199,100,40,60,199,Auction
3435000,1275,935,185,250,200,50,260,Auction
3438544,700,390,290,205,105,100,140,Auction
3438819,500,220,174,190,155,35,149,Auction
3439155,950,545,299,175,140,35,299,Auction
3442088,700,375,219,380,230,150,219,Auction
3442113,900,520,215,605,325,280,403,Auction
3441495,1700,1305,289,1265,815,450,139,Auction
3443113,400,115,175,75,50,25,-20,Auction
3434064,1500,1160,185,375,300,75,1035,Auction
3445303,400,115,175,40,20,20,100,Auction
3445789,900,545,225,490,270,220,-103.75,Auction
3446568,850,455,285,170,135,35,481.25,Auction
3446768,500,190,200,155,120,35,425,Auction
3447904,750,430,240,220,120,100,315,Auction
3448436,375,90,175,135,75,60,145.45,Auction
3448486,375,185,80,200,150,50,530,Auction
3448958,850,470,224,600,320,280,224,Auction
3449065,825,460,205,230,130,100,355,Auction
3449115,450,165,175,105,45,60,125,Auction
3449183,400,165,100,185,150,35,-200,Auction
3448640,225,15,100,15,5,10,95.45,Auction
3450376,625,315,200,100,40,60,571.37,Auction
3449533,1500,910,389,810,470,340,1889,Auction
3420390,575,250,215,260,210,50,-10,Auction
3425255,475,205,160,135,100,35,317.25,Auction
3426291,675,385,180,160,140,20,-270,Auction
3426891,975,630,239,430,375,55,1464,Auction
3427257,550,245,199,265,165,100,224,Auction
3427291,1425,1015,300,270,220,50,-25,Auction
3429865,700,355,340,270,220,50,-85,Auction
3426691,850,525,170,565,315,250,-180,Auction
3408858,900,550,194,330,280,50,-206,Auction
3431171,950,590,224,425,205,220,274,Auction
3431673,500,220,174,150,115,35,374,Auction
3432071,525,235,184,275,225,50,159,Auction
3432137,1050,620,324,10,5,5,324,Auction
3432207,450,190,150,150,115,35,50,Auction
3432909,1075,690,220,155,135,20,-55,Auction
3433024,1825,1355,364,830,490,340,239,Auction
3433294,550,205,215,175,140,35,390,Auction
3433394,775,390,519,155,95,60,644,Auction
3433879,1250,710,430,790,480,310,1280,Auction
3429850,875,525,195,210,110,100,152.75,Auction
3432873,1150,695,275,380,230,150,275,Auction
3434681,1550,1130,310,1460,960,500,810,Auction
3434932,400,90,200,125,90,35,250,Auction
3434979,675,330,235,190,155,35,110,Auction
3435130,625,300,215,160,140,20,215,Auction
3368946,1925,1335,439,800,460,340,114,Auction
3435717,875,525,220,450,230,220,345,Auction
3436017,400,210,80,75,50,25,180,Auction
3435815,600,290,199,250,210,40,124,Auction
3436102,625,335,184,100,65,35,259,Auction
3436887,1225,840,275,500,250,250,50,Auction
3437104,1550,1120,324,855,515,340,74,Auction
3437353,850,505,235,220,170,50,-315,Auction
3438023,500,240,145,240,190,50,170,Auction
3440210,1150,660,380,305,155,150,130,Auction
3440276,450,145,199,155,135,20,-126,Auction
3407607,1225,715,365,710,400,310,1140,Auction
3442418,525,220,199,125,90,35,49,Auction
3443154,875,520,249,700,390,310,149,Auction
3444120,525,220,199,55,30,25,124,Auction
3445575,725,375,244,190,155,35,244,Auction
3447162,750,410,234,400,180,220,234,Auction
3447413,725,390,229,395,245,150,304,Auction
3447649,1150,665,304,435,215,220,304,Auction
3447849,300,85,105,80,55,25,-20,Auction
3447998,550,260,180,150,115,35,-95,Auction
3449385,475,240,125,135,100,35,-50,Auction
3449806,475,165,200,180,145,35,150,Auction
3450521,900,520,270,150,115,35,145,Auction
3425693,1075,555,414,555,305,250,189,Auction
3425736,2025,1425,494,1320,870,450,1319,Auction
3426027,925,570,249,175,115,60,324,Auction
3426329,975,485,384,285,235,50,9,Auction
3426336,975,560,270,250,150,100,95,Auction
3427365,1350,840,400,890,550,340,250,Auction
3428401,450,195,149,110,50,60,149,Auction
3428399,400,175,165,35,15,20,-64.55,Auction
3424055,475,230,110,250,200,50,-90,Auction
3428644,1550,1020,400,235,135,100,0,Auction
3428901,950,585,255,860,520,340,80,Auction
3429644,325,155,60,160,125,35,315,Auction
3429780,575,290,255,190,155,35,-20,Auction
3429835,525,220,199,135,100,35,24,Auction
3430414,1250,860,240,185,150,35,190,Auction
3432643,1200,700,394,300,150,150,94,Auction
3433579,2425,1950,369,1645,1095,550,1544,Auction
3412666,850,455,230,525,275,250,380,Auction
3434524,1200,795,439,155,120,35,3164,Auction
3435251,650,335,209,275,175,100,859,Auction
3435760,500,195,199,190,155,35,124,Auction
3436796,675,355,204,240,140,100,204,Auction
3436789,1950,1475,369,185,125,60,-831,Auction
3437225,400,120,174,110,90,20,174,Auction
3428565,575,250,215,170,135,35,65,Auction
3439797,575,270,199,100,40,60,1324,Auction
3439997,925,570,199,320,170,150,224,Auction
3440131,550,205,235,205,155,50,135,Auction
3440297,425,115,200,80,60,20,-100,Auction
3440433,500,215,175,170,135,35,-33.25,Auction
3441210,625,340,175,90,65,25,650,Auction
3441269,1675,1115,454,635,355,280,454,Auction
3432545,775,450,175,130,110,20,125,Auction
3426434,875,485,229,235,185,50,654,Auction
3358005,850,500,244,300,225,75,-106,Auction
3442582,575,290,175,138,80,58,425,Auction
3443041,2525,2035,380,2200,1550,650,805,Auction
3444077,1400,965,325,700,390,310,-25,Auction
3444520,775,485,180,95,75,20,230,Auction
3423219,1925,1390,425,1300,1075,225,500,Auction
3421513,625,320,174,265,215,50,199,Auction
3445983,8200,6645,1877.49,4790,3990,800,777.49,Auction
3446049,550,240,200,270,170,100,300,Auction
3397992,550,240,200,175,140,35,228.62,Auction
3436632,1825,1245,449,1305,855,450,824,Auction
3447328,400,115,175,70,45,25,-25,Auction
3445654,825,380,270,80,55,25,-155,Auction
3420620,3275,2620,439,1410,910,500,439,Auction
3427166,1275,885,284,460,350,110,534,Auction
3428605,1100,605,389,605,325,280,89,Auction
3429273,1100,770,224,170,150,20,-476,Auction
3430059,525,245,174,85,60,25,174,Auction
3430191,750,465,175,250,200,50,575,Auction
3344690,600,270,224,230,130,100,524,Auction
3431127,775,345,320,220,170,50,-62,Auction
3386737,1000,580,274,265,165,100,774,Auction
3431931,1100,675,255,730,420,310,130,Auction
3432246,1275,695,474,505,255,250,1449,Auction
3432463,950,635,205,725,415,310,2505,Auction
3432600,475,230,135,160,100,60,-15,Auction
3433336,475,170,199,145,110,35,124,Auction
3435007,450,170,174,200,100,100,-201,Auction
3436408,700,410,194,125,65,60,144,Auction
3426180,525,240,175,140,80,60,250,Auction
3438062,725,340,274,100,65,35,949,Auction
3439015,600,325,165,75,50,25,-260,Auction
3440220,975,485,309,220,170,50,334,Auction
3440352,450,145,199,160,125,35,149,Auction
3440505,875,480,229,410,190,220,104,Auction
3438497,700,420,174,485,265,220,149,Auction
3442024,775,390,279,500,250,250,104,Auction
3442342,1000,550,344,355,205,150,344,Auction
3442424,375,185,80,55,30,25,-70,Auction
3442441,600,285,205,200,150,50,180,Auction
3443010,1075,715,254,360,210,150,54,Auction
3443177,575,315,150,230,180,50,100,Auction
3444981,600,265,200,115,55,60,500,Auction
3428370,625,275,199,240,140,100,924,Auction
3445917,900,475,315,470,250,220,-360,Auction
3445967,750,445,195,265,215,50,645,Auction
3448457,2200,1715,375,1225,775,450,-525,Auction
3449026,775,385,280,280,180,100,105,Auction
3449579,525,205,255,80,60,20,130,Auction
3449848,2375,1895,374,2295,1645,650,1199,Auction
3449997,250,40,100,60,35,25,550,Auction
3450247,525,270,145,140,80,60,170,Auction
3434285,5575,4630,835,4550,3750,800,260,Auction
3451465,375,165,155,195,135,60,-45,Auction
3451652,1500,985,409,955,585,370,359,Auction
3451937,550,265,175,195,160,35,-250,Auction
3452370,625,305,199,345,195,150,699,Auction
3425543,775,450,219,178,145,33,219,Auction
3424305,850,400,364,250,215,35,14,Auction
3426484,400,215,79,225,125,100,279,Auction
3359357,1375,860,405,870,530,340,430,Auction
3426888,525,215,200,190,155,35,125,Auction
3427288,1150,750,290,670,390,280,440,Auction
3427815,875,505,264,450,230,220,264,Auction
3427883,575,305,160,150,115,35,35,Auction
3428058,1350,785,455,165,105,60,-545,Auction
3427713,725,425,150,150,115,35,-225,Auction
3428151,450,145,199,10,5,5,124,Auction
3428215,750,430,214,257,205,52,164,Auction
3428551,1750,1285,359,690,410,280,-341,Auction
3429887,850,555,174,500,250,250,370,Auction
3430598,675,390,179,305,230,75,254,Auction
3429117,850,460,229,335,185,150,279,Auction
3432436,775,425,240,195,135,60,165,Auction
3431861,475,195,174,62,35,27,324,Auction
3433597,525,220,199,165,105,60,374,Auction
3434142,1350,910,330,50,30,20,-495,Auction
3427547,700,350,240,200,165,35,1190,Auction
3434499,550,230,210,185,165,20,185,Auction
3434674,725,355,214,250,150,100,214,Auction
3435537,800,405,285,155,120,35,485,Auction
3435512,1650,1190,350,870,530,340,900,Auction
3435912,1275,760,409,395,245,150,434,Auction
3436780,325,155,60,145,95,50,435,Auction
3437116,725,400,204,168,110,58,104,Auction
3437618,800,405,289,550,300,250,189,Auction
3428492,275,115,50,55,30,25,-50,Auction
3437975,650,330,185,210,160,50,360,Auction
3438077,575,260,205,385,235,150,126.25,Auction
3439856,550,295,149,270,170,100,299,Auction
3440451,400,210,80,130,70,60,155,Auction
3439286,1225,715,400,735,425,310,625,Auction
3440860,1600,1145,345,910,540,370,245,Auction
3441694,425,140,175,170,135,35,96.25,Auction
3441719,500,215,175,75,55,20,150,Auction
3441919,725,445,174,370,220,150,174,Auction
3442128,425,115,200,140,80,60,75,Auction
3442196,525,235,184,190,130,60,609,Auction
3442289,1175,795,270,50,25,25,-555,Auction
3442464,525,265,150,160,140,20,425,Auction
3442621,800,485,209,125,90,35,209,Auction
3443259,700,335,205,335,185,150,5,Auction
3443298,625,310,179,175,140,35,154,Auction
3443323,675,340,204,165,105,60,129,Auction
3444370,675,335,230,160,125,35,-170,Auction
3445370,2125,1640,375,655,375,280,100,Auction
3445404,850,510,234,510,260,250,984,Auction
3422388,425,165,150,120,85,35,-25,Auction
3422838,750,445,195,415,195,220,245,Auction
3423088,425,145,174,125,105,20,-51,Auction
3423174,1300,755,375,90,65,25,114.8,Auction
3423374,1300,800,390,815,475,340,309,Auction
3423509,500,220,174,130,70,60,174,Auction
3424224,475,215,160,180,160,20,610,Auction
3424359,675,340,184,180,160,20,109,Auction
3425445,975,600,269,310,260,50,394,Auction
3425495,525,240,175,265,180,85,25,Auction
3425260,350,45,199,75,50,25,199,Auction
3425931,825,495,220,275,225,50,1095,Auction
3418193,550,240,200,170,135,35,1046.25,Auction
3417107,1950,1315,440,530,280,250,-410,Auction
3426296,525,215,200,345,195,150,-75,Auction
3426431,675,390,175,250,200,50,-75,Auction
3427018,775,415,224,185,150,35,324,Auction
3401732,500,195,199,150,115,35,1099,Auction
3429289,1000,675,180,220,180,40,580,Auction
3429875,1925,1335,484,1120,720,400,505,Auction
3430176,750,445,195,650,370,280,495,Auction
3430576,2200,1545,549,840,500,340,249,Auction
3430811,400,150,140,80,65,15,40,Auction
3430411,900,545,205,265,215,50,-95,Auction
3431711,775,450,215,440,220,220,640,Auction
3432483,400,180,110,200,165,35,135,Auction
3432998,875,530,239,325,175,150,537.5,Auction
3433083,1000,575,315,300,225,75,290,Auction
3433669,1950,1435,409,1005,605,400,259,Auction
3433769,775,485,180,170,110,60,405,Auction
3430026,1325,795,335,480,260,220,-215,Auction
3433134,725,385,185,135,115,20,-115,Auction
3418444,1225,655,370,160,140,20,545,Auction
3434569,850,480,235,490,380,110,585,Auction
3434820,650,315,225,205,155,50,125,Auction
3432247,525,215,200,220,120,100,625,Auction
3434956,525,190,225,65,40,25,-125,Auction
3387875,475,190,175,180,145,35,125,Auction
3436527,900,545,245,390,240,150,52.75,Auction
3438600,700,355,230,330,255,75,505,Auction
3438864,1100,710,280,135,100,35,130,Auction
3439350,575,290,255,395,245,150,1280,Auction
3439635,1350,925,254,1260,810,450,-196,Auction
3440572,2400,1970,324,1110,710,400,1174,Auction
3441957,975,670,199,550,485,65,224,Auction
3442593,575,280,189,125,90,35,14,Auction
3443529,450,170,174,90,65,25,297.5,Auction
3433984,675,350,175,75,55,20,100,Auction
3444080,1450,935,325,650,405,245,425,Auction
3445016,475,195,174,55,35,20,-101,Auction
3423288,475,170,199,145,85,60,99,Auction
3446987,575,270,199,185,125,60,324,Auction
3379208,1250,675,469,455,345,110,669,Auction
3426776,1175,775,294,240,140,100,419,Auction
3428010,1050,590,284,165,145,20,234,Auction
3428146,525,245,174,175,140,35,-176,Auction
3428197,1100,700,334,490,380,110,334,Auction
3428312,500,220,199,155,120,35,349,Auction
3428697,700,300,290,190,155,35,-185,Auction
3428846,500,220,174,125,65,60,124,Auction
3429282,1675,1165,369,1375,925,450,294,Auction
3429948,900,570,224,275,225,50,299,Auction
3431990,500,215,175,110,90,20,175,Auction
3391544,800,445,245,195,135,60,45,Auction
3432456,600,340,150,265,165,100,150,Auction
3433826,1775,1310,359,575,325,250,-316,Auction
3430584,725,350,215,405,185,220,-110,Auction
3431218,900,455,270,410,190,220,520,Auction
3427074,500,240,120,135,100,35,95,Auction
3431220,1050,695,199,515,265,250,1349,Auction
3434964,1625,1035,815,1035,635,400,65,Auction
3434062,1575,995,470,85,65,20,127.75,Auction
3435147,1350,1020,219,940,845,95,219,Auction
3436034,750,485,159,410,355,55,1009,Auction
3436700,825,520,155,140,80,60,30,Auction
3437621,500,235,155,215,165,50,-170,Auction
3433141,775,425,195,210,160,50,-155,Auction
3429248,2350,1865,300,845,505,340,-650,Auction
3437970,350,185,59,90,65,25,509,Auction
3438121,1575,1040,425,100,40,60,1400,Auction
3437485,500,215,175,145,125,20,-25,Auction
3440344,1275,855,310,1265,815,450,35,Auction
3440744,550,260,175,100,40,60,-50,Auction
3425940,725,415,179,95,70,25,854,Auction
3440163,675,390,174,155,95,60,47.5,Auction
3440965,900,505,234,770,460,310,1434,Auction
3438357,500,190,200,170,150,20,-125,Auction
3441650,450,165,175,75,55,20,-175,Auction
3441899,625,300,219,365,215,150,-106,Auction
3442201,675,315,205,420,200,220,680,Auction
3442352,1325,900,255,90,65,25,580,Auction
3442935,500,215,175,190,170,20,200,Auction
3443137,900,480,264,125,105,20,264,Auction
3443773,600,300,174,65,40,25,-1,Auction
3444388,700,410,184,225,125,100,384,Auction
3444909,700,410,184,395,320,75,384,Auction
3445979,600,265,225,170,150,20,-200,Auction
3446194,775,490,179,245,195,50,179,Auction
3446245,650,305,249,130,110,20,-151,Auction
3446445,825,505,219,550,300,250,729,Auction
3447366,650,305,239,155,95,60,264,Auction
3443922,675,370,190,240,205,35,565,Auction
3447881,775,465,235,195,160,35,410,Auction
3449672,575,295,174,150,115,35,299,Auction
3446111,550,235,204,200,150,50,854,Auction
3430135,600,320,174,245,145,100,324,Auction
3450991,325,155,60,135,100,35,60,Auction
3451257,850,470,349,240,140,100,599,Auction
3418654,600,285,205,185,125,60,-124.65,Auction
3451644,450,165,175,80,60,20,-125,Auction
3453163,3000,2445,449,75,50,25,2549,Auction
3454801,1825,1300,754,790,480,310,229,Auction
3455488,575,280,189,220,170,50,214,Auction
3456707,500,195,199,180,145,35,249,Auction
3457560,925,585,230,685,405,280,355,Auction
3457607,1225,820,299,150,115,35,299,Auction
3455735,1100,605,389,500,250,250,689,Auction
3458443,700,340,254,185,125,60,257.5,Auction
3459615,700,420,174,150,115,35,224,Auction
3459696,450,200,130,195,175,20,-20,Auction
3451791,525,215,200,189,130,59,25,Auction
3438974,850,525,215,585,335,250,365,Auction
3460417,1000,625,340,250,200,50,265,Auction
3462223,1300,815,375,330,180,150,175,Auction
3459079,550,265,179,135,100,35,179,Auction
3439425,625,275,199,245,145,100,374,Auction
3462540,400,95,199,36,15,21,1099,Auction
3463510,525,220,199,155,120,35,199,Auction
3463523,800,405,244,215,115,100,294,Auction
3463925,775,465,165,285,185,100,1340,Auction
3465095,725,390,184,190,130,60,159,Auction
3447523,775,430,239,310,160,150,239,Auction
3447638,400,215,79,220,170,50,79,Auction
3436528,625,325,174,170,110,60,174,Auction
3449896,1075,715,254,335,260,75,204,Auction
3449495,325,110,105,147,110,37,130,Auction
3451767,1000,545,345,755,445,310,120,Auction
3451968,2725,2145,410,165,105,60,835,Auction
3452403,3050,2315,625,1475,975,500,2425,Auction
3453190,600,270,224,245,145,100,-76,Auction
3453939,400,95,199,124,65,59,149,Auction
3454025,325,105,100,155,105,50,1025,Auction
3454039,850,440,340,515,265,250,532,Auction
3454375,1225,780,339,113,55,58,599,Auction
3454761,1225,780,339,670,390,280,364,Auction
3454962,1050,670,244,495,275,220,670.71,Auction
3455476,475,190,175,190,155,35,175,Auction
3456498,1575,720,388.73,490,270,220,213.73,Auction
3456948,400,175,115,190,155,35,-10,Auction
3457870,500,215,175,95,70,25,275,Auction
3457884,800,445,245,455,235,220,840.45,Auction
3458856,1025,585,330,765,455,310,1355,Auction
3454926,475,165,200,100,0,100,125,Auction
3459006,425,145,174,165,130,35,49,Auction
3459005,675,390,175,270,220,50,75,Auction
3460391,1575,915,550,500,375,125,-325,Auction
3460442,675,350,200,145,85,60,150,Auction
3460842,950,560,280,805,465,340,530,Auction
3461928,850,460,284,400,180,220,134,Auction
3452103,1075,730,190,560,310,250,315,Auction
3462449,750,385,255,235,185,50,505,Auction
3449387,700,385,180,440,385,55,-170,Auction
3450089,1425,990,329,1215,765,450,1354,Auction
3450123,1475,945,424,1085,685,400,424,Auction
3450204,800,445,249,400,180,220,1772.5,Auction
3450538,975,530,335,770,460,310,1010,Auction
3430033,675,335,199,300,150,150,174,Auction
3451210,600,295,195,195,160,35,45,Auction
3448051,450,145,199,160,125,35,199,Auction
3451876,775,400,265,315,240,75,890,Auction
3451895,1350,820,424,465,245,220,-326,Auction
3452012,1925,1465,350,1215,765,450,175,Auction
3452076,750,405,235,290,240,50,260,Auction
3452995,475,195,174,45,25,20,99,Auction
3453031,1425,915,400,415,195,220,675,Auction
3453195,275,115,65,140,105,35,-60,Auction
3453633,325,105,110,75,50,25,-115,Auction
3453448,1150,605,439,795,485,310,589,Auction
3422130,775,400,215,335,260,75,165,Auction
3454733,400,115,175,111,50,61,25,Auction
3454818,575,255,214,440,220,220,64,Auction
3455869,500,220,174,65,40,25,174,Auction
3456039,425,145,174,125,90,35,249,Auction
3456220,425,120,199,5,5,0,224,Auction
3456490,725,385,215,160,125,35,40,Auction
3457392,2325,1940,224,1280,830,450,-751,Auction
3457841,475,165,215,170,135,35,-35,Auction
3442701,675,355,214,205,170,35,214,Auction
3460434,625,300,215,420,200,220,65,Auction
3426653,900,615,179,500,375,125,279,Auction
3427482,725,370,249,440,220,220,249,Auction
3428025,775,410,255,180,145,35,101.25,Auction
3428732,475,205,130,210,160,50,-145,Auction
3380266,625,315,200,405,295,110,525,Auction
3426203,775,400,215,385,235,150,-260,Auction
3417079,450,210,105,95,75,20,30,Auction
3431197,375,95,199,50,30,20,324,Auction
3431290,825,505,210,160,100,60,-140,Auction
3432026,475,170,199,150,115,35,-151,Auction
3432269,1375,810,459,179,120,59,59,Auction
3432476,450,170,174,85,60,25,324,Auction
3433262,1150,665,344,375,225,150,344,Auction
3433505,350,120,120,85,60,25,-30,Auction
3429911,825,505,170,405,295,110,395,Auction
3436463,325,110,105,65,40,25,30,Auction
3436570,900,525,269,265,215,50,269,Auction
3435627,425,145,174,170,135,35,199,Auction
3437499,1150,780,264,1095,695,400,264,Auction
3437542,775,430,239,380,305,75,239,Auction
3433898,900,545,195,170,110,60,220,Auction
3438721,700,420,174,475,255,220,149,Auction
3438735,950,605,235,430,320,110,-215,Auction
3439328,725,355,214,275,225,50,214,Auction
3439507,650,355,189,280,230,50,189,Auction
3440050,1700,1150,440,760,450,310,1790,Auction
3441000,425,145,174,35,15,20,174,Auction
3441250,325,105,130,80,55,25,5,Auction
3442072,500,215,175,190,170,20,100,Auction
3442965,700,435,269,290,255,35,219,Auction
3437399,875,525,195,380,230,150,148.1,Auction
3423295,750,395,249,135,75,60,499,Auction
3407912,3775,3100,565,2430,1780,650,1440,Auction
3444651,1075,630,339,185,150,35,264,Auction
3445387,975,510,295,615,335,280,95,Auction
3443865,550,270,174,50,25,25,1124,Auction
3440464,625,360,154,410,355,55,629,Auction
3445780,575,250,215,260,160,100,-10,Auction
3446173,750,430,240,360,210,150,390,Auction
3446409,3800,3120,570,1810,1210,600,1120,Auction
3447552,525,260,345,130,95,35,595,Auction
3448381,400,120,174,135,75,60,174,Auction
3426259,1500,1085,305,170,135,35,651.25,Auction
3426495,725,425,190,330,180,150,865,Auction
3427240,1350,785,455,195,160,35,205,Auction
3427967,425,145,174,150,100,50,174,Auction
3428097,625,335,265,185,125,60,-110,Auction
3429076,900,595,199,585,335,250,199,Auction
3396586,775,450,215,340,190,150,290,Auction
3429569,700,445,149,400,290,110,149,Auction
3429803,1100,625,369,880,540,340,369,Auction
3429810,1300,945,245,160,125,35,1145,Auction
3430103,575,250,215,225,175,50,-135,Auction
3430439,750,385,259,275,225,50,134,Auction
3430605,525,215,200,120,85,35,-75,Auction
3430641,575,265,204,380,230,150,179,Auction
3430646,475,190,175,64,45,19,225,Auction
3430746,275,20,154,35,15,20,204,Auction
3431348,525,215,200,250,200,50,375,Auction
3432120,600,290,204,200,150,50,204,Auction
3432477,575,280,189,90,65,25,1014,Auction
3399987,800,465,180,154,95,59,30,Auction
3430005,725,375,244,255,220,35,144,Auction
3435028,700,390,190,140,80,60,165,Auction
3435819,1325,860,355,1030,630,400,580,Auction
3434526,625,335,180,175,140,35,-120,Auction
3436721,700,305,244,460,240,220,644,Auction
3437098,325,115,100,90,65,25,50,Auction
3427297,350,130,100,45,25,20,25,Auction
3419916,1050,585,285,525,275,250,160,Auction
3437991,525,220,209,155,135,20,334,Auction
3438270,1775,1305,360,1175,775,400,485,Auction
3438434,525,190,225,70,45,25,436,Auction
3438929,1050,585,440,655,375,280,290,Auction
3440199,700,335,240,300,150,150,40,Auction
3440701,700,335,205,300,150,150,105,Auction
3442137,800,390,304,200,150,50,229,Auction
3442907,1775,1395,715,355,205,150,1390,Auction
3443216,550,285,155,325,250,75,76.62,Auction
3443807,4150,3415,555,1275,825,450,2905,Auction
3422115,950,585,205,335,185,150,1005,Auction
3444979,750,390,250,380,230,150,225,Auction
3424123,1350,920,255,720,410,310,955,Auction
3396588,650,300,200,195,160,35,-100,Auction
3445822,575,250,215,65,40,25,365,Auction
3445824,350,135,105,100,65,35,-145,Auction
3445888,600,280,210,76,50,26,110,Auction
3446024,450,200,175,175,140,35,75,Auction
3446122,825,450,269,390,240,150,744,Auction
3442514,700,395,199,170,150,20,199,Auction
3447058,900,505,289,185,150,35,289,Auction
3447294,525,245,174,65,40,25,499,Auction
3448060,600,240,204,95,70,25,1204,Auction
3447987,925,540,275,635,355,280,1250,Auction
3448094,550,265,175,100,40,60,-350,Auction
3448353,525,245,174,40,20,20,-251,Auction
3426490,425,145,174,55,30,25,249,Auction
3427341,2150,1385,655,775,465,310,55,Auction
3427809,475,195,174,125,65,60,149,Auction
3428060,1375,810,459,250,215,35,1549.25,Auction
3428413,675,355,194,75,50,25,622.5,Auction
3430417,850,440,300,175,140,35,-350,Auction
3430553,3000,2440,450,145,110,35,550,Auction
3431974,875,415,354,195,135,60,179,Auction
3431987,1175,830,235,505,255,250,760,Auction
3432323,775,415,254,180,145,35,704,Auction
3433829,500,250,140,205,155,50,115,Auction
3422648,675,370,155,120,60,60,180,Auction
3411735,1600,1230,209,1245,795,450,309,Auction
3434880,1425,935,384,750,670,80,809,Auction
3426809,875,525,195,160,140,20,245,Auction
3435816,1225,820,299,280,230,50,316.5,Auction
3436250,1100,710,280,80,60,20,230,Auction
3436284,400,95,199,125,65,60,199,Auction
3436484,875,485,280,385,235,150,-24.65,Auction
3439109,1550,1005,435,1200,750,450,2081.25,Auction
3439692,300,85,105,65,40,25,25.45,Auction
3360240,1325,735,355,560,310,250,-170,Auction
3441313,2475,1920,445,240,205,35,-580,Auction
3441981,1200,675,415,645,365,280,315,Auction
3442198,700,325,269,200,150,50,-181,Auction
3442232,1450,920,335,1155,755,400,-665,Auction
3443253,1025,620,299,305,155,150,249,Auction
3443402,400,115,175,130,70,60,75,Auction
3443521,400,120,174,75,50,25,74,Auction
3444257,450,140,200,135,100,35,100,Auction
3444623,550,240,200,140,105,35,125,Auction
3445159,1500,1010,345,155,95,60,1795,Auction
3445176,975,605,260,395,245,150,-115,Auction
3417785,775,410,205,340,190,150,105,Auction
3411850,575,265,199,125,90,35,24,Auction
3446061,1000,530,364,580,330,250,164,Auction
3445410,1150,660,380,370,220,150,180,Auction
3446580,625,285,200,255,155,100,300,Auction
3446929,1050,615,325,535,285,250,-400,Auction
3447733,625,335,180,270,170,100,455,Auction
3426711,825,420,290,300,225,75,215,Auction
3427056,525,245,174,235,200,35,149,Auction
3427847,500,215,175,130,95,35,125,Auction
3428183,325,45,174,30,10,20,199,Auction
3357219,650,265,250,100,45,55,-200,Auction
3429217,1650,1110,434,970,600,370,284,Auction
3429285,1150,700,329,345,195,150,679,Auction
3429919,1250,775,290,955,585,370,690,Auction
3430264,1125,675,275,620,375,245,-400,Auction
3430596,550,235,204,150,115,35,-121,Auction
3430757,700,370,175,210,160,50,-375,Auction
3432259,800,485,205,400,180,220,5,Auction
3432370,625,315,200,150,115,35,-150,Auction
3432502,675,350,215,295,195,100,115,Auction
3434042,475,190,175,165,130,35,350,Auction
3419423,850,445,239,455,235,220,-11,Auction
3413182,600,270,224,200,150,50,174,Auction
3430898,550,245,199,235,135,100,599,Auction
3435033,475,195,174,63,40,23,249,Auction
3435344,875,485,264,670,390,280,-511,Auction
3435978,675,355,214,150,90,60,39,Auction
3436539,600,265,225,310,160,150,-125,Auction
3428719,700,385,169,350,275,75,-331,Auction
3437284,1725,1295,324,1165,765,400,324,Auction
3440624,2200,1500,594,890,550,340,294,Auction
3440794,500,220,174,123,65,58,424,Auction
3438084,775,410,205,445,225,220,305,Auction
3425911,1300,935,209,155,95,60,809,Auction
3441930,575,270,199,185,150,35,49,Auction
3444227,1025,545,295,170,135,35,770,Auction
3444593,1875,1400,365,770,460,310,340,Auction
3444997,600,285,200,500,250,250,0,Auction
3442389,800,470,179,330,180,150,379,Auction
3438118,875,460,249,225,125,100,249,Auction
3446065,325,155,60,150,115,35,135,Auction
3446810,525,245,174,145,125,20,249,Auction
3447367,300,90,100,140,80,60,50,Auction
3448035,800,460,240,240,140,100,390,Auction
3448380,1200,695,315,445,225,220,265,Auction
3448605,850,480,210,465,245,220,185,Auction
3448737,525,245,174,245,195,50,449,Auction
3449150,650,350,190,16,10,6,-380,Auction
3450018,2775,2180,489,1745,1195,550,489,Auction
3449507,950,495,279,255,205,50,129,Auction
3461721,675,370,195,170,110,60,370,Auction
3462455,575,295,174,57,30,27,174,Auction
3463006,775,390,279,75,55,20,404,Auction
3463106,825,530,215,335,185,150,490,Auction
3463757,725,385,230,255,205,50,55,Auction
3463991,1675,1165,404,725,415,310,479,Auction
3464193,725,415,294,255,155,100,144,Auction
3464978,800,425,269,180,120,60,94,Auction
3465565,975,580,289,165,105,60,164,Auction
3465580,1025,520,399,350,200,150,399,Auction
3466935,1350,940,304,1095,695,400,229,Auction
3467352,525,220,199,124,65,59,374,Auction
3467435,1225,745,374,375,225,150,374,Auction
3467988,525,215,200,260,210,50,-25,Auction
3468671,475,165,200,205,155,50,100,Auction
3468807,400,115,175,70,55,15,100,Auction
3468824,825,490,229,380,230,150,254,Auction
3469358,525,215,200,250,200,50,175,Auction
3469709,550,210,234,75,55,20,84,Auction
3469724,900,480,314,375,300,75,814,Auction
3470109,775,430,239,690,410,280,114,Auction
3466752,900,545,195,305,155,150,220,Auction
3462800,1775,1215,415,820,480,340,736.37,Auction
3463014,675,385,180,475,255,220,305,Auction
3463099,550,235,264,235,185,50,389,Auction
3463349,600,320,174,420,200,220,374,Auction
3464971,1350,745,495,245,210,35,1695,Auction
3465222,1775,1345,324,1015,615,400,1149,Auction
3465521,550,245,199,275,225,50,-151,Auction
3465922,1525,1150,315,490,270,220,190,Auction
3466457,850,505,235,45,25,20,735,Auction
3464635,800,500,150,375,300,75,1050,Auction
3463985,1100,645,275,625,345,280,625,Auction
3464250,1250,885,205,565,315,250,105,Auction
3401596,3625,2935,465,890,550,340,440,Auction
3467694,600,300,369,215,115,100,169,Auction
3419230,425,115,215,75,50,25,215,Auction
3468679,675,320,314,275,225,50,1039,Auction
3469751,1600,1050,350,1000,660,340,150,Auction
3434566,750,395,249,270,170,100,249,Auction
3434952,500,195,239,190,155,35,114,Auction
3435545,1350,860,364,215,165,50,239,Auction
3435695,975,605,260,50,25,25,-15,Auction
3435938,950,540,300,345,270,75,-250,Auction
3436002,300,145,49,125,90,35,124,Auction
3436088,225,15,100,35,15,20,125,Auction
3437567,600,315,175,275,225,50,-103.38,Auction
3436545,1750,1110,429,1280,830,450,179,Auction
3435888,875,560,165,295,195,100,290,Auction
3427857,850,465,220,585,335,250,348.2,Auction
3438217,725,440,179,275,225,50,-121,Auction
3425249,750,430,240,220,170,50,490,Auction
3439532,425,115,200,127,65,62,-25,Auction
3439689,525,220,199,179,120,59,-126,Auction
3440475,750,410,234,125,90,35,284,Auction
3440725,1725,1245,374,625,345,280,549,Auction
3442061,350,135,105,145,125,20,30,Auction
3442847,850,485,209,200,100,100,309,Auction
3443033,650,365,155,295,195,100,130,Auction
3360764,2300,1840,350,1620,1070,550,450,Auction
3441218,1100,730,210,45,25,20,810,Auction
3445512,1275,795,370,500,375,125,495,Auction
3445841,1325,905,314,585,335,250,334,Auction
3446484,400,215,134,70,50,20,134,Auction
3448663,1650,1140,320,445,225,220,-505,Auction
3449556,925,510,385,240,140,100,230.35,Auction
3450978,1475,915,365,420,200,220,240,Auction
3451428,475,190,175,150,115,35,-50,Auction
3431451,775,370,295,315,165,150,295,Auction
3451971,550,235,209,225,175,50,59,Auction
3452350,725,390,229,110,50,60,104,Auction
3453200,1325,860,355,460,240,220,780,Auction
3453936,550,235,209,325,175,150,509,Auction
3453993,500,215,275,125,90,35,200,Auction
3453086,675,390,174,185,165,20,174,Auction
3455708,500,195,199,150,115,35,224,Auction
3455458,350,75,105,55,30,25,80,Auction
3456051,1850,1285,459,1050,650,400,109,Auction
3455901,450,140,200,110,50,60,-50,Auction
3456787,900,435,289,390,315,75,839,Auction
3457137,500,215,175,75,50,25,275,Auction
3456637,700,415,175,275,175,100,-400,Auction
3454272,2550,2060,309,1305,855,450,359,Auction
3449857,1000,595,235,180,120,60,45,Auction
3450370,800,465,225,155,120,35,-75,Auction
3450500,800,405,285,415,195,220,135,Auction
3449100,475,165,200,50,25,25,350,Auction
3430807,900,525,214,685,405,280,214,Auction
3451272,1600,1015,475,465,245,220,825,Auction
3451563,825,485,210,125,65,60,-115,Auction
3451663,375,185,80,105,85,20,-120,Auction
3451863,1400,970,324,160,100,60,124,Auction
3452701,775,485,180,15,5,10,205,Auction
3452835,675,370,195,100,40,60,165.45,Auction
3452742,1150,660,305,635,355,280,505,Auction
3452899,1150,665,379,415,195,220,729,Auction
3453135,950,585,255,785,475,310,1055,Auction
3453844,375,95,174,50,25,25,499,Auction
3443582,575,290,175,180,145,35,50,Auction
3455314,375,70,199,120,60,60,224,Auction
3457179,875,415,284,465,245,220,409,Auction
3455916,950,590,204,110,50,60,142,Auction
3452865,975,550,250,275,175,100,575,Auction
3458522,675,385,180,145,85,60,80,Auction
3458681,1725,1260,355,665,525,140,180,Auction
3458924,475,170,199,95,70,25,224,Auction
3459017,750,445,199,350,200,150,199,Auction
3459517,1150,695,345,655,375,280,1840.45,Auction
3460087,375,155,110,210,110,100,85,Auction
3460196,550,235,244,135,75,60,-206,Auction
3460289,1050,695,249,620,340,280,299,Auction
3460587,375,190,79,95,70,25,79,Auction
3460789,1200,855,464,615,335,280,64,Auction
3461825,900,545,440,385,235,150,265,Auction
3419574,350,105,139,75,55,20,39,Auction
3419735,900,430,360,360,285,75,210,Auction
3393034,725,355,214,225,125,100,289,Auction
3421207,2100,1675,315,465,245,220,911.62,Auction
3364781,1050,670,274,805,465,340,424,Auction
3420267,850,520,179,185,125,60,29,Auction
3418013,675,285,225,355,205,150,-350,Auction
3422250,975,585,280,270,170,100,80,Auction
3422407,625,320,199,265,215,50,-176,Auction
3422543,925,540,275,585,335,250,175,Auction
3422650,675,315,250,150,115,35,-50,Auction
3422668,475,235,109,155,120,35,109,Auction
3423479,1675,1080,485,660,380,280,110,Auction
3423186,950,635,175,400,290,110,525,Auction
3424872,400,210,80,70,55,15,-145,Auction
3424858,725,350,260,150,115,35,-15,Auction
3424747,3000,2330,449,1285,835,450,1149,Auction
3425165,625,305,174,190,170,20,-251,Auction
3425283,3750,3080,454,685,405,280,454,Auction
3427037,950,515,329,355,205,150,179,Auction
3427755,600,290,204,370,220,150,204,Auction
3430963,500,215,175,240,140,100,625,Auction
3431156,575,295,174,185,150,35,49,Auction
3431560,525,240,175,75,55,20,-260,Auction
3432453,875,530,239,300,150,150,239,Auction
3432496,500,215,175,110,50,60,-85,Auction
3432560,600,270,224,260,225,35,174,Auction
3432610,525,245,174,305,230,75,99,Auction
3435061,500,190,200,170,150,20,-100,Auction
3435286,375,95,174,110,50,60,249,Auction
3415916,1000,645,245,275,225,50,120,Auction
3435618,500,220,194,250,200,50,94,Auction
3436447,600,325,135,124,70,54,35,Auction
3437801,500,190,200,95,70,25,-178.63,Auction
3433764,625,320,174,270,220,50,274,Auction
3438737,650,350,190,240,190,50,-10,Auction
3438980,1675,1215,354,665,385,280,979,Auction
3439630,875,485,284,215,165,50,284,Auction
3440341,250,105,39,100,65,35,189,Auction
3440584,1825,1240,665,800,460,340,190,Auction
3440809,375,155,110,150,90,60,106.25,Auction
3441838,650,315,225,175,155,20,-75,Auction
3442481,975,680,189,500,375,125,189,Auction
3442638,1750,1195,355,1065,665,400,1205,Auction
3443013,375,70,199,50,25,25,174,Auction
3442077,725,385,230,250,150,100,480,Auction
3443749,1625,1165,350,280,230,50,825,Auction
3441995,975,580,234,235,185,50,859,Auction
3441195,1650,975,455,265,215,50,-345,Auction
3439716,600,315,175,355,205,150,-100,Auction
3436315,675,370,159,230,180,50,-16,Auction
3444285,400,115,175,90,70,20,-155,Auction
3444417,925,565,250,75,55,20,375,Auction
3444621,850,445,239,150,115,35,239,Auction
3448567,775,390,224,345,195,150,124,Auction
3450056,650,370,149,160,140,20,149,Auction
3450507,925,540,275,430,210,220,175,Auction
3450541,2025,1300,474.37,1780,1230,550,-250.63,Auction
3443270,675,285,229,125,90,35,229,Auction
3451107,700,360,215,335,260,75,240,Auction
3451341,925,550,265,500,375,125,990,Auction
3451426,925,585,315,105,45,60,772.75,Auction
3451460,625,295,220,350,200,150,245,Auction
3451494,750,430,210,280,180,100,185,Auction
3452077,1275,860,309,110,90,20,484,Auction
3452460,2075,1325,514,665,425,240,514,Auction
3453081,2175,1475,590,1670,1120,550,915,Auction
3453145,650,365,175,140,105,35,-225,Auction
3453583,375,165,100,180,160,20,0,Auction
3453881,975,560,305,195,135,60,480,Auction
3454149,700,325,269,170,135,35,469,Auction
3454234,475,165,200,110,50,60,-25,Auction
3454468,425,140,175,100,65,35,50,Auction
3453264,875,460,249,500,250,250,474,Auction
3455302,725,355,264,395,245,150,1039,Auction
3455387,1175,765,379,385,235,150,1404,Auction
3455702,1025,520,399,290,190,100,174,Auction
3455736,725,395,190,275,225,50,515,Auction
3455719,475,195,174,160,125,35,99,Auction
3456089,725,410,175,195,135,60,-200,Auction
3456791,1275,755,335,425,225,200,810,Auction
3459012,800,385,245,595,345,250,245,Auction
3459365,425,120,199,60,40,20,199,Auction
3460616,750,430,220,170,110,60,120,Auction
3461786,750,430,220,210,110,100,270,Auction
3437744,900,570,179,650,370,280,1279,Auction
3450801,775,390,269,335,185,150,294,Auction
3450894,1025,600,319,440,220,220,794,Auction
3451230,1400,855,350,755,445,310,-325,Auction
3451448,1200,755,270,285,185,100,220,Auction
3452366,875,565,369,260,225,35,244,Auction
3452852,625,285,230,265,215,50,205,Auction
3452991,675,370,315,220,170,50,190,Auction
3454320,1550,1100,340,250,150,100,690,Auction
3454456,1100,755,239,500,375,125,239,Auction
3452255,725,350,215,290,255,35,265,Auction
3455149,450,140,200,135,75,60,50,Auction
3455592,1100,660,334,860,520,340,334,Auction
3456135,1325,965,715,335,260,75,890,Auction
3456310,675,315,205,120,100,20,405,Auction
3456821,700,370,220,265,215,50,120,Auction
3457110,2400,1930,290,1020,620,400,340,Auction
3456392,400,120,174,150,115,35,124,Auction
3458289,1425,1060,255,240,190,50,1430,Auction
3458743,1350,980,264,500,375,125,564,Auction
3459007,625,285,200,470,250,220,-75,Auction
3458021,750,430,220,190,155,35,562,Auction
3461433,1000,600,234,210,110,100,534,Auction
3462058,600,285,205,170,110,60,105,Auction
3462351,875,525,240,250,150,100,115,Auction
3462637,525,215,200,110,50,60,50,Auction
3462662,450,165,175,150,90,60,25,Auction
3463823,600,280,210,315,240,75,360,Auction
3464198,625,295,220,350,200,150,70,Auction
3464759,575,290,175,45,25,20,100,Auction
3462687,375,65,200,90,65,25,75,Auction
3448744,725,385,230,250,150,100,-295,Auction
3448893,1125,735,229,540,290,250,254,Auction
3449930,1050,690,200,175,140,35,-25,Auction
3431163,1200,735,359,255,155,100,359,Auction
3426901,1050,585,285,305,230,75,-315,Auction
3451616,1550,1005,435,950,580,370,185,Auction
3454156,350,185,69,175,140,35,119,Auction
3454691,675,355,214,380,230,150,539,Auction
3455831,900,495,299,560,310,250,1549,Auction
3456031,350,135,105,35,15,20,-95,Auction
3456482,2450,1895,855,395,245,150,505,Auction
3426016,250,105,39,120,60,60,39,Auction
3445200,675,350,175,225,190,35,350,Auction
3458971,600,320,174,75,50,25,324,Auction
3455546,2425,1945,370,1200,750,450,95,Auction
3459490,750,475,169,170,110,60,169,Auction
3460993,400,175,115,185,150,35,-185,Auction
3460558,850,470,549,150,100,50,1299,Auction
3461912,1500,980,410,1045,645,400,1260,Auction
3444281,700,320,215,230,180,50,340,Auction
3431096,700,335,205,90,65,25,30,Auction
3450127,525,245,174,180,120,60,274,Auction
3463238,2025,1285,634,565,315,250,609,Auction
3463395,700,370,175,405,185,220,250,Auction
3465510,1350,920,320,500,375,125,120,Auction
3465703,375,120,149,40,20,20,99,Auction
3465803,375,90,175,55,30,25,-25,Auction
3465969,975,550,344,345,195,150,319,Auction
3457922,450,145,199,100,40,60,49,Auction
3452399,400,175,100,155,120,35,800,Auction
3468048,550,265,175,145,85,60,50,Auction
3468318,725,410,215,290,255,35,890,Auction
3468618,275,65,100,62,35,27,275,Auction
3469013,250,40,100,140,105,35,75,Auction
3469054,675,350,215,105,70,35,215,Auction
3469213,850,485,239,395,245,150,264,Auction
3469956,900,595,199,515,265,250,2799,Auction
3470190,650,330,180,230,190,40,30,Auction
3459348,2475,1870,395,730,420,310,1020,Auction
3462573,1175,740,264,400,345,55,314,Auction
3463390,925,585,230,710,555,155,105,Auction
3463509,375,190,79,135,115,20,79,Auction
3433761,1050,670,270,335,185,150,95,Auction
3465045,1525,925,490,1100,700,400,415,Auction
3466147,875,590,369,555,305,250,369,Auction
3466283,575,250,215,150,115,35,190,Auction
3466351,800,485,209,280,230,50,234,Auction
3466917,750,475,165,255,155,100,965,Auction
3467151,550,275,169,260,225,35,-181,Auction
3467185,300,140,50,160,125,35,25,Auction
3469708,425,120,199,223,175,48,299,Auction
3470091,725,400,334,190,130,60,309,Auction
3471078,350,135,105,45,25,20,225.45,Auction
3453579,975,560,249,335,185,150,149,Auction
3442640,800,405,230,450,230,220,780,Auction
3459859,3050,2485,459,1340,890,450,586.91,Auction
3460002,325,115,100,110,75,35,400,Auction
3462210,1450,1010,330,530,280,250,280,Auction
3463646,650,300,240,145,110,35,-185,Auction
3463739,625,345,174,125,65,60,249,Auction
3463889,750,445,199,140,120,20,149,Auction
3464246,800,405,289,155,120,35,289,Auction
3464639,1650,1110,1094,405,295,110,194,Auction
3464789,1550,1175,265,500,250,250,1015,Auction
3375997,2500,2020,299,1290,840,450,799,Auction
3464089,850,470,274,385,235,150,274,Auction
3465182,950,535,309,250,200,50,109,Auction
3465282,450,140,200,155,95,60,225,Auction
3465811,700,405,185,220,170,50,160,Auction
3465868,500,180,214,170,135,35,164,Auction
3457630,575,300,135,80,55,25,-265,Auction
3378719,575,280,185,165,105,60,235,Auction
3466797,500,215,175,220,170,50,75,Auction
3466954,550,245,199,175,140,35,224,Auction
3467647,850,550,175,159,100,59,375,Auction
3467890,875,525,240,85,60,25,365,Auction
3464959,800,405,289,250,215,35,239,Auction
3465441,750,445,195,275,225,50,-105,Auction
3466402,400,120,174,135,75,60,374,Auction
3466938,1875,1310,819,630,350,280,169,Auction
3467006,1125,590,429,175,140,35,304,Auction
3467156,1325,730,485,620,340,280,1360,Auction
3467499,400,120,174,75,50,25,474,Auction
3458982,550,265,175,190,155,35,875,Auction
3468167,625,300,219,450,230,220,394,Auction
3469185,425,120,199,90,65,25,249,Auction
3469253,900,480,249,390,240,150,249,Auction
3469921,450,195,149,90,65,25,74,Auction
3454077,1275,825,344,640,360,280,269,Auction
3470564,600,300,194,320,170,150,569,Auction
3448848,1675,1130,354,1465,965,500,354,Auction
3450988,625,335,180,155,95,60,-20,Auction
3452281,825,485,230,310,160,150,230,Auction
3453026,600,295,195,295,195,100,395,Auction
3453719,1425,1065,254,710,400,310,129,Auction
3453787,525,215,200,200,150,50,75,Auction
3454464,775,485,180,435,215,220,130,Auction
3454523,525,215,200,115,55,60,475,Auction
3451954,650,285,205,320,170,150,-70,Auction
3453251,600,340,154,275,225,50,154,Auction
3423435,1950,1215,500,625,345,280,800,Auction
3455625,525,215,200,170,135,35,-178.75,Auction
3455723,700,370,424,415,305,110,324,Auction
3420670,525,245,174,165,105,60,174,Auction
3456361,550,265,175,160,125,35,225,Auction
3456838,2500,2015,375,1665,1115,550,125,Auction
3456961,700,390,175,335,185,150,25,Auction
3457638,650,390,150,160,125,35,700,Auction
3458272,825,425,294,425,205,220,269,Auction
3458935,425,145,174,125,65,60,229.21,Auction
3458965,475,190,175,155,120,35,50,Auction
3459442,650,340,200,410,300,110,150,Auction
3459467,500,195,199,205,170,35,-1,Auction
3461616,675,315,250,115,55,60,400,Auction
3461739,450,170,174,30,10,20,174,Auction
3461875,950,515,329,365,215,150,479,Auction
3462016,4425,3650,665,2805,2105,700,1090,Auction
3459846,600,305,179,150,115,35,179,Auction
3462820,1650,1060,484,810,470,340,384,Auction
3463815,625,295,220,165,105,60,70,Auction
3470492,2850,2260,484,550,485,65,1634,Auction
3470883,575,275,194,180,160,20,-81,Auction
3470926,475,190,175,200,150,50,180,Auction
3467684,925,520,235,175,140,35,310,Auction
3460832,675,390,179,245,145,100,104,Auction
3471483,600,300,194,300,150,150,994,Auction
3443775,3525,2885,425,150,115,35,750,Auction
3472085,1375,900,365,890,550,340,790,Auction
3431716,950,540,300,385,235,150,175,Auction
3473264,775,390,349,310,160,150,674,Auction
3473321,2150,1560,385,185,165,20,935,Auction
3462066,600,325,165,155,120,35,615,Auction
3473391,800,420,270,250,150,100,345,Auction
3473798,175,15,54,5,5,0,79,Auction
3471283,1175,625,569,180,145,35,294,Auction
3471728,875,570,175,175,115,60,433.61,Auction
3460696,550,265,174,205,155,50,124,Auction
3443051,675,375,174,210,160,50,174,Auction
3464945,3350,2700,544,2125,1475,650,494,Auction
3465647,2500,2015,375,1875,1275,600,575,Auction
3466234,1000,605,285,775,465,310,135,Auction
3468119,650,365,175,260,210,50,200,Auction
3468187,700,340,204,112,75,37,304,Auction
3468272,875,475,290,195,135,60,90,Auction
3468740,2050,1570,394,1400,900,500,944,Auction
3469659,425,140,175,65,40,25,175,Auction
3469625,825,460,255,190,155,35,30,Auction
3470680,875,460,309,300,250,50,1634,Auction
3471144,625,360,155,470,360,110,780,Auction
3469357,900,520,215,275,175,100,665,Auction
3462690,725,385,185,470,360,110,210,Auction
3448365,900,480,249,320,170,150,249,Auction
3471446,475,165,200,135,100,35,425,Auction
3472969,1500,970,424,1005,605,400,424,Auction
3472986,725,350,245,345,195,150,70,Auction
3473169,975,660,209,515,265,250,209,Auction
3466282,475,190,175,140,80,60,425,Auction
3461087,625,360,150,195,160,35,200,Auction
3466669,825,465,254,655,375,280,129,Auction
3467084,675,355,214,160,100,60,239,Auction
3468039,800,465,225,405,295,110,325,Auction
3468420,1050,585,355,225,175,50,705,Auction
3463774,775,465,179,250,150,100,154,Auction
3468556,475,190,175,65,40,25,-54.55,Auction
3470611,600,270,199,164,130,34,-1,Auction
3470328,700,370,175,315,240,75,371.62,Auction
3471264,850,510,234,235,185,50,234,Auction
3463940,1075,740,370,355,205,150,695,Auction
3472026,1475,1065,304,650,370,280,1004,Auction
3476506,800,405,289,275,225,50,289,Auction
3476965,725,385,230,485,265,220,130,Auction
3477708,275,75,74,75,55,20,199,Auction
3478578,400,155,115,95,70,25,15,Auction
3478637,600,300,174,130,95,35,174,Auction
3477835,550,275,149,170,135,35,149,Auction
3480116,400,135,150,135,100,35,425,Auction
3480173,525,215,290,155,120,35,190,Auction
3480207,775,415,254,255,155,100,479,Auction
3480309,500,195,199,205,155,50,124,Auction
3481179,500,250,140,150,115,35,190,Auction
3481422,750,415,225,275,225,50,225,Auction
3482522,575,220,245,125,65,60,145,Auction
3449617,425,145,174,155,95,60,174,Auction
3449667,525,215,200,100,40,60,25,Auction
3449810,450,140,200,75,50,25,150,Auction
3449960,800,525,165,210,175,35,265,Auction
3449874,1100,620,370,375,300,75,570,Auction
3450074,800,500,190,475,255,220,65,Auction
3450303,600,270,224,195,135,60,174,Auction
3421480,625,345,135,66,40,26,310,Auction
3450760,1275,795,374,540,290,250,374,Auction
3451239,700,415,175,160,125,35,-200,Auction
3447302,350,130,110,163,130,33,60,Auction
3451403,525,240,175,75,50,25,150,Auction
3451453,1450,1010,265,495,275,220,-385,Auction
3452732,775,385,280,275,225,50,455,Auction
3452775,725,410,205,115,55,60,830,Auction
3453361,800,425,404,200,100,100,154,Auction
3453425,500,180,214,105,85,20,214,Auction
3453954,775,480,185,280,180,100,185,Auction
3454454,1050,615,325,785,475,310,125,Auction
3447252,750,370,219,325,250,75,319,Auction
3455090,775,450,215,235,200,35,490,Auction
3455433,600,295,190,185,125,60,515,Auction
3457898,575,290,175,180,145,35,150,Auction
3425960,525,220,199,125,90,35,424,Auction
3458791,425,145,174,129,95,34,199,Auction
3460563,600,315,145,345,305,40,70,Auction
3460820,425,140,175,155,135,20,-25,Auction
3460870,525,240,175,360,210,150,100,Auction
3461313,775,400,365,275,225,50,140,Auction
3445531,425,145,174,129,70,59,249,Auction
3446233,525,240,175,36,15,21,-200,Auction
3446365,1100,645,279,505,255,250,279,Auction
3446676,500,175,215,135,100,35,-60,Auction
3447144,550,230,315,260,160,100,65,Auction
3447110,525,220,199,260,210,50,124,Auction
3447910,975,535,269,440,220,220,269,Auction
3449407,1150,665,304,175,155,20,154,Auction
3449616,1325,915,304,380,305,75,204,Auction
3451888,3225,2635,484,1480,980,500,2859,Auction
3452224,700,335,255,290,190,100,55,Auction
3430096,525,215,200,160,100,60,275,Auction
3453687,775,390,319,415,195,220,319,Auction
3454262,550,245,199,125,90,35,224,Auction
3454330,575,290,175,220,170,50,250,Auction
3367020,625,335,180,70,45,25,-270,Auction
3455457,475,165,200,160,125,35,575,Auction
3456895,425,140,175,135,75,60,100,Auction
3458397,650,335,209,85,60,25,-66,Auction
3438141,1100,710,390,650,370,280,390,Auction
3459333,600,295,195,135,75,60,170,Auction
3460469,725,390,189,105,50,55,114,Auction
3460503,1775,1415,254,1215,765,450,254,Auction
3460814,1000,550,289,340,290,50,-361,Auction
3463745,875,460,309,510,260,250,134,Auction
3464149,1425,875,350,215,165,50,125,Auction
3454106,1425,805,414,250,200,50,689,Auction
3452570,1375,1045,179,880,710,170,204,Auction
3454778,900,460,334,355,205,150,134,Auction
3454323,375,95,174,85,60,25,49,Auction
3455864,550,260,180,210,175,35,-20,Auction
3456681,975,535,319,180,120,60,194,Auction
3456850,500,195,199,160,140,20,49,Auction
3457332,475,170,209,310,160,150,234,Auction
3458003,525,215,200,145,125,20,125,Auction
3457250,2375,1940,260,695,555,140,1285,Auction
3460076,1175,825,244,840,755,85,369,Auction
3461326,600,315,175,215,115,100,75,Auction
3462062,925,540,275,380,230,150,450,Auction
3463666,575,255,199,125,90,35,199,Auction
3464301,525,255,164,260,225,35,139,Auction
3464955,300,140,50,160,125,35,225,Auction
3465474,2025,1385,534,1050,650,400,409,Auction
3466024,1900,1425,345,865,525,340,188.4,Auction
3462785,700,325,269,160,100,60,269,Auction
3462928,750,390,250,65,40,25,496.25,Auction
3464464,600,295,175,135,115,20,350,Auction
3465350,1525,1000,365,305,155,150,1040,Auction
3455383,950,575,215,150,115,35,215,Auction
3467358,600,320,174,265,215,50,174,Auction
3467672,850,445,299,350,275,75,2399,Auction
3467815,675,335,234,105,45,60,159,Auction
3469037,575,280,179,285,235,50,204,Auction
3423209,1250,835,245,190,155,35,895,Auction
3470166,950,495,349,250,150,100,1699,Auction
3402210,575,270,199,220,120,100,324,Auction
3457205,1050,610,334,495,275,220,484,Auction
3469214,950,635,240,600,320,280,440,Auction
3470035,375,95,174,110,50,60,149,Auction
3470304,550,260,180,80,55,25,55,Auction
3470300,600,315,175,65,40,25,0,Auction
3457064,650,335,204,400,290,110,204,Auction
3471422,825,460,255,180,145,35,301.25,Auction
3472039,2325,1940,279,1040,640,400,229,Auction
3472226,625,335,184,255,205,50,184,Auction
3473043,625,320,174,165,115,50,349,Auction
3473376,550,265,175,180,120,60,525,Auction
3473861,1100,660,334,605,325,280,334,Auction
3473911,3425,2805,514,1370,920,450,1289,Auction
3474498,550,230,205,250,165,85,405,Auction
3474830,275,65,84,80,60,20,84,Auction
3466241,850,470,219,725,415,310,169,Auction
3471507,675,350,200,220,170,50,248.43,Auction
3476184,950,465,454,330,180,150,254,Auction
3471278,650,330,210,235,185,50,-115,Auction
3471312,775,385,280,410,300,110,255,Auction
3471499,475,190,175,100,80,20,300,Auction
3472197,1125,640,375,525,275,250,695.45,Auction
3472465,1475,945,369,890,550,340,494,Auction
3473120,325,105,114,135,100,35,89,Auction
3473367,1175,680,335,375,225,150,1156.62,Auction
3473635,250,65,70,55,30,25,45,Auction
3474822,575,265,204,140,80,60,129,Auction
3475124,950,560,280,410,190,220,380,Auction
3473754,625,305,214,275,225,50,289,Auction
3454851,750,410,199,215,165,50,174,Auction
3475558,675,315,250,150,115,35,450,Auction
3476311,275,80,89,60,35,25,239,Auction
3476494,4200,3460,630,1320,870,450,1830,Auction
3476762,825,420,295,350,200,150,470,Auction
3476894,525,220,199,250,150,100,149,Auction
3477162,950,605,235,190,155,35,235,Auction
3425404,1000,530,294,445,225,220,294,Auction
3472117,625,285,234,160,100,60,109,Auction
3472632,900,475,315,260,210,50,140,Auction
3473417,625,250,265,60,35,25,215,Auction
3474238,550,240,200,220,170,50,500,Auction
3474287,875,485,284,385,235,150,709,Auction
3474687,2475,2025,969,240,205,35,1394,Auction
3475459,375,120,119,135,115,20,219,Auction
3404931,550,265,179,200,150,50,229,Auction
3475625,275,90,75,115,80,35,100,Auction
3476910,350,180,80,190,140,50,605,Auction
3477546,975,560,254,300,245,55,-21,Auction
3478767,375,120,119,85,60,25,94,Auction
3479033,725,410,205,465,245,220,80,Auction
3468633,1000,625,315,360,210,150,165,Auction
3469076,825,500,219,325,250,75,1419,Auction
3469155,775,385,280,215,115,100,105,Auction
3469562,575,280,179,260,160,100,179,Auction
3470141,450,140,200,45,25,20,25,Auction
3471098,575,320,149,270,235,35,174,Auction
3469362,875,485,225,110,50,60,-350,Auction
3467283,800,445,199,75,55,20,699,Auction
3471734,400,145,149,165,105,60,224,Auction
3471884,925,565,250,670,390,280,300,Auction
3472413,500,240,154,275,225,50,154,Auction
3472720,1775,1075,590,655,375,280,565,Auction
3474142,775,450,215,325,275,50,490,Auction
3475728,450,145,199,100,65,35,149,Auction
3476107,775,425,230,600,320,280,80,Auction
3446089,975,680,154,300,225,75,279,Auction
3448790,800,430,214,615,335,280,114,Auction
3448854,550,235,209,175,140,35,9,Auction
3449083,400,115,175,105,45,60,25,Auction
3445957,800,465,180,170,135,35,-195,Auction
3449472,550,245,199,195,160,35,324,Auction
3450351,550,260,180,95,75,20,-95,Auction
3415966,775,415,204,275,175,100,29,Auction
3450955,1675,1130,439,760,450,310,164,Auction
3451262,425,140,175,129,70,59,950,Auction
3413851,450,145,199,74,50,24,-24.29,Auction
3452198,600,295,195,90,65,25,95,Auction
3452348,1150,665,379,350,275,75,-121,Auction
3452823,575,255,214,205,105,100,-186,Auction
3452934,350,180,60,80,60,20,510,Auction
3453534,700,340,254,370,220,150,204,Auction
3453084,1350,820,339,1240,790,450,339,Auction
3454088,525,195,199,210,160,50,74,Auction
3454338,1275,860,309,570,320,250,1134,Auction
3439898,400,210,80,160,140,20,355,Auction
3456253,625,255,264,150,115,35,214,Auction
3456835,750,405,235,90,65,25,310,Auction
3456971,1300,945,245,130,110,20,-80,Auction
3457721,650,345,179,275,225,50,779,Auction
3458214,800,450,240,220,185,35,365,Auction
3456235,750,405,190,120,60,60,15,Auction
3455249,1650,1275,214,190,155,35,1364,Auction
3458507,450,170,174,124,65,59,125.71,Auction
3458707,1125,585,430,515,265,250,55,Auction
3458793,375,190,79,65,40,25,4,Auction
3458925,2150,1605,439,1070,670,400,1189,Auction
3479620,1000,495,395,250,150,100,545,Auction
3479718,450,145,199,175,140,35,199,Auction
3480105,300,140,50,45,25,20,225,Auction
3480503,375,120,149,135,100,35,99,Auction
3480741,750,470,174,195,160,35,2024,Auction
3482192,450,170,174,140,105,35,-26,Auction
3436719,1825,1210,429,1145,745,400,1204,Auction
3482862,700,370,220,245,210,35,70,Auction
3482977,475,190,175,225,125,100,300,Auction
3483428,400,175,115,190,155,35,265,Auction
3483498,550,245,199,185,150,35,149,Auction
3485670,275,70,95,60,35,25,-5,Auction
3470237,825,505,210,240,190,50,-15,Auction
3457033,775,465,160,415,305,110,160,Auction
3471323,1900,1425,340,560,310,250,1640,Auction
3452018,475,170,199,180,145,35,174,Auction
3471173,850,510,194,30,10,20,194,Auction
3472724,900,475,315,405,185,220,40,Auction
3472974,2150,1560,480,2185,1535,650,430,Auction
3473410,1950,1375,469,210,160,50,469,Auction
3473546,450,145,199,155,120,35,199,Auction
3473696,1325,800,419,600,320,280,1194,Auction
3473895,750,465,144,400,200,200,269,Auction
3475081,1500,865,494,645,365,280,494,Auction
3470887,1550,1040,270,590,340,250,120,Auction
3458519,650,315,200,250,215,35,700,Auction
3475331,600,295,199,325,275,50,149,Auction
3464187,950,545,239,375,225,150,889,Auction
3464605,1300,815,375,1030,630,400,-175,Auction
3465005,600,270,219,270,220,50,169,Auction
3465106,1300,750,350,515,265,250,1550,Auction
3469417,425,140,175,70,55,15,150,Auction
3443646,1100,730,210,505,255,250,560,Auction
3471604,800,520,149,375,300,75,649,Auction
3471654,950,535,319,200,165,35,169,Auction
3472025,350,110,120,95,70,25,-5,Auction
3477150,675,330,235,265,215,50,160,Auction
3477936,3300,2700,494,1150,750,400,2194,Auction
3478279,850,440,240,315,165,150,540,Auction
3478486,300,60,129,75,50,25,229,Auction
3425642,250,65,70,105,50,55,120,Auction
3467183,775,450,175,335,185,150,175,Auction
3481294,925,525,294,770,460,310,463.94,Auction
3481594,1125,680,339,405,185,220,1389,Auction
3482616,1525,1005,414,470,250,220,314,Auction
3482959,575,305,164,310,235,75,689,Auction
3483266,325,90,129,100,65,35,129,Auction
3485095,850,550,190,300,225,75,140,Auction
3485667,350,105,114,128,95,33,114,Auction
3448589,400,140,150,140,120,20,0,Auction
3449223,1025,595,320,220,170,50,170,Auction
3448823,1050,640,244,525,275,250,1194,Auction
3449366,925,565,200,640,360,280,150,Auction
3450968,1250,800,344,350,200,150,344,Auction
3451038,900,595,199,230,180,50,199,Auction
3451095,475,165,204,200,150,50,129,Auction
3451295,625,255,229,275,175,100,-221,Auction
3451604,975,580,289,535,285,250,914,Auction
3452267,500,250,140,150,90,60,65,Auction
3452333,1125,775,215,310,160,150,240,Auction
3454246,1900,1365,575,1210,760,450,1025,Auction
3454448,775,450,215,210,160,50,140,Auction
3443180,800,420,215,340,190,150,515,Auction
3452810,650,320,200,385,310,75,75,Auction
3454948,425,200,115,125,65,60,165,Auction
3455205,800,405,289,500,250,250,89,Auction
3454446,2875,2335,434,1840,1240,600,3659,Auction
3439863,1625,1035,480,835,495,340,-170,Auction
3456341,850,525,215,250,200,50,190,Auction
3456284,750,405,235,290,190,100,-265,Auction
3456711,650,300,200,240,205,35,-150,Auction
3457111,375,190,79,70,45,25,79,Auction
3457990,700,375,219,265,165,100,472.5,Auction
3458383,825,460,255,210,160,50,780,Auction
3458883,1250,900,244,535,285,250,194,Auction
3458949,725,415,184,135,75,60,184,Auction
3458283,575,305,250,125,65,60,-25,Auction
3459383,500,195,199,210,160,50,99,Auction
3460555,375,120,149,36,15,21,124,Auction
3460864,575,255,199,415,215,200,149,Auction
3472504,775,405,224,135,100,35,49,Auction
3473308,575,280,194,185,150,35,44,Auction
3473533,675,375,174,485,265,220,449,Auction
3473640,825,380,335,240,190,50,160,Auction
3474051,525,245,219,75,55,20,219,Auction
3468210,900,520,215,135,75,60,165,Auction
3476055,375,150,115,125,90,35,290,Auction
3475362,525,215,200,115,55,60,150,Auction
3476205,500,195,199,155,95,60,149,Auction
3474176,400,185,85,185,125,60,85,Auction
3477902,625,285,234,240,190,50,459,Auction
3478920,325,110,105,90,65,25,280,Auction
3479263,400,155,135,182,120,62,151.75,Auction
3485867,1125,680,339,335,185,150,464,Auction
3486560,750,410,234,105,45,60,684,Auction
3486960,775,385,280,135,100,35,805,Auction
3489225,2075,1385,580,840,500,340,255,Auction
3490304,575,260,205,200,150,50,80,Auction
3484652,1150,665,304,275,225,50,354,Auction
3490461,725,350,215,100,65,35,190,Auction
3491290,650,370,174,350,200,150,749,Auction
3492483,650,350,270,80,55,25,120,Auction
3472608,850,505,190,10,5,5,190,Auction
3473194,1050,610,294,290,240,50,294,Auction
3474297,375,165,100,206,155,51,175,Auction
3474365,500,195,199,189,155,34,272.5,Auction
3475015,175,10,55,10,5,5,0.45,Auction
3475066,1225,655,370,745,435,310,120,Auction
3471858,950,530,310,455,235,220,351.75,Auction
3476619,725,355,264,280,180,100,139,Auction
3478142,375,120,149,90,65,25,174,Auction
3478223,450,140,200,170,110,60,250,Auction
3478423,350,180,60,115,55,60,-40,Auction
3479342,500,195,229,170,110,60,229,Auction
3479410,1350,950,290,945,575,370,188,Auction
3479628,875,505,264,435,215,220,289,Auction
3465317,600,265,200,180,145,35,125,Auction
3450116,425,170,115,190,155,35,-85,Auction
3466832,750,410,234,290,190,100,484,Auction
3465892,850,525,215,495,275,220,190,Auction
3466998,800,405,289,265,215,50,289,Auction
3467321,600,300,194,135,100,35,194,Auction
3467793,1325,925,290,700,390,310,115,Auction
3468402,1700,1270,440,195,135,60,240,Auction
3468661,500,215,175,170,150,20,225,Auction
3471401,450,170,194,170,150,20,44,Auction
3472176,400,165,125,125,90,35,150,Auction
3472737,275,75,90,95,70,25,-10,Auction
3472746,875,455,310,285,185,100,175,Auction
3473014,750,430,214,550,300,250,64,Auction
3474018,800,445,304,295,195,100,904,Auction
3473237,625,285,234,150,90,60,259,Auction
3473335,800,465,340,580,330,250,690,Auction
3473935,2025,1545,370,1400,900,500,3140.45,Auction
3474739,350,115,125,65,40,25,150,Auction
3475573,550,245,199,100,65,35,249,Auction
3475777,700,390,175,150,115,35,41.75,Auction
3476862,275,70,75,100,65,35,75,Auction
3477598,625,255,269,215,165,50,294,Auction
3478717,5050,4180,610,4585,3785,800,260,Auction
3475075,1500,1085,245,595,345,250,295,Auction
3386629,650,355,174,250,200,50,474,Auction
3480304,850,555,189,325,175,150,189,Auction
3483015,1650,1090,450,985,615,370,400,Auction
3475427,1200,695,315,815,475,340,215,Auction
3483624,2025,1385,534,1430,930,500,409,Auction
3483751,725,340,279,240,140,100,154,Auction
3483894,400,140,150,140,80,60,75,Auction
3483994,375,150,104,80,55,25,104,Auction
3484360,525,270,200,185,150,35,75,Auction
3485187,250,40,100,50,25,25,25,Auction
3465867,1275,795,299,740,430,310,224,Auction
3488138,225,30,85,70,50,20,135,Auction
3488597,850,400,344,250,200,50,-6,Auction
3488731,650,365,175,415,305,110,350,Auction
3489440,1800,1275,415,370,220,150,1215,Auction
3489810,875,455,310,105,45,60,210,Auction
3472200,875,515,204,360,310,50,129,Auction
3472249,400,175,115,155,135,20,115,Auction
3472919,950,515,279,275,190,85,379,Auction
3434781,750,445,155,520,270,250,405,Auction
3453614,350,135,85,83,65,18,435,Auction
3382484,1350,745,395,735,425,310,345,Auction
3477114,925,565,250,365,215,150,1125,Auction
3477080,850,545,159,310,260,50,159,Auction
3476201,300,95,95,86,65,21,45,Auction
3476387,575,255,214,170,150,20,214,Auction
3476601,675,375,194,235,185,50,119,Auction
3476720,1475,975,394,940,845,95,1419,Auction
3476970,1200,635,455,380,305,75,255,Auction
3478659,650,365,140,150,115,35,390,Auction
3431595,5050,4180,760,150,90,60,294,Auction
3479646,475,220,169,160,140,20,194,Auction
3479928,1100,645,279,635,355,280,179,Auction
3477388,600,265,260,245,145,100,185,Auction
3480128,975,550,369,620,340,280,494,Auction
3480646,225,80,39,115,80,35,89,Auction
3481399,775,450,215,280,230,50,490,Auction
3481667,725,365,250,165,105,60,145,Auction
3482536,450,145,199,125,90,35,49,Auction
3483004,700,390,200,175,115,60,175,Auction
3490210,675,385,180,375,300,75,255,Auction
3491875,1750,1285,359,235,200,35,509,Auction
3492341,650,305,239,170,110,60,239,Auction
3492684,675,355,174,270,235,35,99,Auction
3492877,1000,550,344,775,465,310,2344,Auction
3494813,925,510,305,600,320,280,880,Auction
3494949,625,335,219,195,160,35,169,Auction
3495326,1950,1375,469,905,535,370,894,Auction
3494649,850,525,215,390,340,50,165,Auction
3495885,725,390,229,190,170,20,1104,Auction
3496528,1975,1570,295,765,455,310,2170,Auction
3496855,525,215,200,155,135,20,50,Auction
3497357,1475,915,360,820,530,290,135,Auction
3448386,1450,895,445,575,325,250,295,Auction
3459393,625,305,214,405,295,110,214,Auction
3460179,650,305,239,200,150,50,239,Auction
3461022,475,170,219,160,100,60,44,Auction
3461383,600,340,150,250,200,50,175,Auction
3461558,425,120,199,100,65,35,199,Auction
3463319,925,495,259,340,190,150,884,Auction
3464055,2950,2400,444,1980,1380,600,1744,Auction
3465809,850,550,190,135,75,60,115,Auction
3466949,900,495,299,365,215,150,224,Auction
3467931,675,390,290,275,225,50,-110,Auction
3464898,900,505,289,195,135,60,289,Auction
3468260,375,155,100,135,75,60,195.45,Auction
3469003,500,220,174,210,175,35,274,Auction
3469021,525,245,174,95,75,20,349,Auction
3480603,1050,585,355,155,95,60,505,Auction
3480753,1500,1085,305,975,605,370,355,Auction
3481378,900,585,205,800,460,340,255,Auction
3481889,375,185,80,180,145,35,126.25,Auction
3481996,425,145,174,135,100,35,149,Auction
3482339,500,215,175,185,125,60,0,Auction
3483207,300,75,114,20,10,10,439,Auction
3483850,975,515,354,325,175,150,479,Auction
3484229,550,225,219,210,175,35,469,Auction
3484472,1875,1250,515,1090,690,400,490,Auction
3485122,650,355,189,200,100,100,289,Auction
3485747,525,245,174,180,145,35,145,Auction
3486808,875,445,344,225,125,100,869,Auction
3482929,400,165,129,200,150,50,129,Auction
3483027,1325,915,304,1050,650,400,304,Auction
3483346,800,365,269,95,75,20,219,Auction
3483495,500,195,199,155,120,35,199,Auction
3483597,1925,1260,559,1275,825,450,559,Auction
3484550,1225,820,299,840,500,340,299,Auction
3484648,1000,675,215,515,265,250,-10,Auction
3486205,1475,1125,244,575,325,250,169,Auction
3437354,600,315,175,250,150,100,400,Auction
3487005,625,255,264,115,80,35,264,Auction
3488477,625,335,184,230,180,50,409,Auction
3495291,1725,1205,410,1150,750,400,1185,Auction
3495634,2250,1765,375,1320,870,450,975,Auction
3497406,275,95,74,50,30,20,94,Auction
3497906,250,105,39,100,65,35,39,Auction
3498392,675,320,249,340,190,150,249,Auction
3499235,825,490,419,490,380,110,494,Auction
3499292,1525,1105,310,845,505,340,785,Auction
3499735,1675,1130,439,620,340,280,1064,Auction
3499335,2200,1495,475,1015,615,400,775,Auction
3500850,375,150,119,125,90,35,544,Auction
3501736,1800,1100,959,375,225,150,459,Auction
3469796,625,285,230,150,115,35,105,Auction
3470893,625,335,215,80,55,25,165,Auction
3464848,425,200,100,140,80,60,325,Auction
3462801,550,240,200,232,130,102,191.75,Auction
3471561,625,315,200,250,215,35,625,Auction
3471650,900,500,290,210,110,100,340,Auction
3471800,725,365,250,335,185,150,521.25,Auction
3472547,750,385,259,305,155,150,259,Auction
3457882,1575,1045,339,500,250,250,664,Auction
3475369,950,515,329,300,150,150,79,Auction
3475462,1500,985,409,650,370,280,1159,Auction
3475744,825,505,210,360,210,150,360,Auction
3475773,475,165,200,120,85,35,-125,Auction
3476291,1175,655,410,1030,630,400,185,Auction
3476305,800,465,190,270,170,100,240,Auction
3476480,475,165,200,160,125,35,300,Auction
3477066,550,285,155,170,110,60,-395,Auction
3472009,1200,820,494,920,550,370,1194,Auction
3472088,575,270,199,235,185,50,99,Auction
3472788,1225,780,335,890,550,340,360,Auction
3472388,725,390,239,210,160,50,614,Auction
3474174,450,165,175,150,115,35,91.75,Auction
3474524,1725,1295,695,685,405,280,320,Auction
3474010,1125,665,280,650,370,280,905,Auction
3470030,1975,1400,374,740,660,80,374,Auction
3448438,1000,565,215,420,200,220,190,Auction
3476982,1050,620,324,395,245,150,624,Auction
3477911,4200,3465,629,1340,890,450,729,Auction
3478511,550,265,175,125,90,35,175,Auction
3474860,1175,715,284,170,110,60,309,Auction
3477247,750,345,235,245,195,50,110,Auction
3478230,275,90,75,20,10,10,150,Auction
3477630,325,105,100,10,5,5,150,Auction
3479051,375,160,109,205,155,50,109,Auction
3478498,875,560,165,595,345,250,590,Auction
3479417,550,230,210,130,110,20,360,Auction
3476996,950,560,284,395,245,150,384,Auction
3482110,725,315,455,170,110,60,530,Auction
3482242,575,290,175,150,115,35,750,Auction
3482812,825,450,279,240,190,50,254,Auction
3484233,350,100,119,85,65,20,119,Auction
3484501,1000,610,284,310,160,150,284,Auction
3484650,1350,920,340,1000,600,400,490,Auction
3484752,1450,940,324,920,550,370,324,Auction
3497691,1575,1155,310,190,170,20,885,Auction
3478201,1575,1030,439,620,340,280,964,Auction
3494983,700,370,175,300,225,75,175,Auction
3499972,600,265,225,270,170,100,350,Auction
3501501,1000,545,345,190,130,60,95,Auction
3501499,675,355,214,375,225,150,339,Auction
3501599,1500,970,494,940,570,370,544,Auction
3501978,850,395,345,375,300,75,270,Auction
3504807,550,270,244,160,100,60,494,Auction
3489328,1100,715,279,330,180,150,229,Auction
3491634,825,485,295,505,255,250,620,Auction
3491434,1425,920,399,1055,655,400,1074,Auction
3414188,625,275,244,275,225,50,494,Auction
3491953,1750,1180,374,1495,995,500,824,Auction
3470544,850,395,300,160,140,20,1000,Auction
3492438,2325,1725,490,1115,715,400,965,Auction
3492570,675,370,195,180,145,35,120,Auction
3493676,375,120,149,155,120,35,174,Auction
3493974,525,215,200,190,155,35,100,Auction
3482295,875,480,229,360,285,75,229,Auction
3491132,625,295,200,265,165,100,-25,Auction
3491804,1275,825,274,425,205,220,299,Auction
3458325,1475,915,450,810,470,340,575,Auction
3477377,650,300,240,125,90,35,140,Auction
3478963,1575,1075,390,95,75,20,865,Auction
3471600,1250,835,245,475,255,220,-5,Auction
3385880,425,145,174,165,105,60,349,Auction
3479563,1950,1470,1040,1825,1225,600,3440,Auction
3479742,600,320,299,55,30,25,320,Auction
3481228,1000,550,394,630,350,280,1494,Auction
3481385,350,135,144,155,95,60,217.5,Auction
3482039,1950,1470,320,1230,780,450,2120,Auction
3483636,400,150,194,120,60,60,294,Auction
3484261,525,245,199,160,125,35,299,Auction
3485840,1125,675,450,675,395,280,275,Auction
3476954,250,55,89,35,15,20,139,Auction
3477404,475,165,204,175,140,35,204,Auction
3477489,900,520,215,170,135,35,215,Auction
3477840,450,140,265,95,75,20,40,Auction
3477889,700,350,240,250,200,50,790,Auction
3479211,900,495,295,665,385,280,245,Auction
3448274,2050,1695,245,1300,850,450,645,Auction
3480498,1925,1350,465,90,65,25,1340,Auction
3480597,250,70,74,95,70,25,124,Auction
3480848,750,385,255,440,220,220,280,Auction
3481284,1250,775,369,845,505,340,369,Auction
3481883,525,190,220,190,155,35,320,Auction
3482919,325,105,114,70,45,25,164,Auction
3483305,1525,1035,384,585,335,250,384,Auction
3483756,825,460,255,335,185,150,130,Auction
3484456,600,270,224,325,175,150,324,Auction
3499505,2900,2355,435,1270,820,450,35,Auction
3499590,575,290,175,250,215,35,750,Auction
3496497,425,170,115,150,115,35,65,Auction
3495378,1475,885,385,630,350,280,1110,Auction
3503117,875,485,245,375,325,50,120,Auction
3499960,575,295,135,235,185,50,310,Auction
3504589,450,170,174,210,160,50,224,Auction
3487712,625,345,165,180,120,60,240,Auction
3487780,925,495,320,520,270,250,545,Auction
3490463,725,315,240,180,145,35,65,Auction
3465659,475,195,174,225,190,35,249,Auction
3492792,650,290,254,190,130,60,204,Auction
3494182,400,145,119,160,140,20,294,Auction
3494739,3175,2590,475,1030,630,400,850,Auction
3463542,450,170,174,220,170,50,174,Auction
3488208,1025,640,279,645,365,280,54,Auction
3488242,775,385,225,285,185,100,200,Auction
3489999,850,485,259,245,195,50,209,Auction
3483547,750,385,205,270,220,50,355,Auction
3480705,1150,600,355,325,275,50,705,Auction
3491101,1375,970,295,640,360,280,270,Auction
3492186,975,630,239,275,225,50,239,Auction
3492924,1525,1005,404,765,455,310,179,Auction
3493307,400,185,105,160,140,20,130,Auction
3493643,2225,1450,620,1890,1290,600,495,Auction
3494058,850,440,300,210,160,50,150,Auction
3494043,300,140,50,150,90,60,425,Auction
3466021,775,430,239,125,90,35,64,Auction
3464924,525,215,200,215,165,50,50,Auction
3466119,400,115,175,85,60,25,125,Auction
3460873,575,250,200,210,160,50,725,Auction
3466923,750,430,179,500,250,250,-21,Auction
3467055,550,235,209,130,95,35,234,Auction
3467834,625,315,265,225,175,50,740,Auction
3468702,475,190,240,60,35,25,185.45,Auction
3470808,550,240,200,75,50,25,175,Auction
3466821,375,90,175,125,65,60,850,Auction
3471135,750,390,250,115,55,60,175,Auction
3471301,1075,745,224,250,150,100,649,Auction
3471744,475,170,199,179,120,59,49,Auction
3471867,375,150,115,125,90,35,165,Auction
3494825,1825,1205,1015,525,275,250,90,Auction
3478620,400,155,110,108,75,33,35,Auction
3495918,800,405,285,135,115,20,535,Auction
3496136,1800,1330,294,1315,950,365,894,Auction
3496386,550,240,200,170,135,35,400,Auction
3496761,1000,600,294,220,170,50,294,Auction
3498233,775,345,270,130,70,60,270,Auction
3498701,725,425,369,430,210,220,144,Auction
3499169,1475,985,380,1175,775,400,205,Auction
3499194,600,265,225,105,45,60,395.45,Auction
3477777,575,295,174,335,185,150,199,Auction
3486376,875,525,205,155,120,35,105,Auction
3501602,825,465,204,425,205,220,1379,Auction
3501934,500,180,199,280,230,50,199,Auction
3502359,1375,835,430,680,400,280,505,Auction
3495245,1400,785,509,1015,615,400,1159,Auction
3495345,800,425,269,320,170,150,319,Auction
3492937,800,390,244,85,60,25,244,Auction
3495930,1050,590,294,710,400,310,244,Auction
3497468,775,425,240,225,175,50,440,Auction
3498623,500,215,175,260,160,100,25,Auction
3498704,525,215,200,85,60,25,525,Auction
3494779,1225,755,360,285,185,100,1435,Auction
3499289,375,185,80,125,90,35,30,Auction
3471130,600,255,200,145,110,35,350,Auction
3402525,1525,990,344,665,385,280,119,Auction
3500359,1425,945,370,610,330,280,1088.4,Auction
3463772,625,320,199,75,50,25,224,Auction
3464199,625,255,264,195,175,20,264,Auction
3462736,975,490,315,415,195,220,265,Auction
3465099,800,405,285,390,240,150,385,Auction
3465701,1075,695,274,550,300,250,899,Auction
3465842,600,265,225,260,160,100,150,Auction
3466071,950,540,300,275,175,100,450,Auction
3466573,850,480,260,210,110,100,610,Auction
3450904,3475,2845,415,150,130,20,-760,Auction
3467809,1575,1125,274,1105,775,330,324,Auction
3469681,700,335,255,125,65,60,1005,Auction
3470288,525,240,175,145,85,60,-100,Auction
3470624,1600,1230,594,1080,680,400,744,Auction
3481173,1075,730,235,930,560,370,210,Auction
3481309,3950,3245,1340,2315,1665,650,190,Auction
3479835,2125,1640,375,910,540,370,850,Auction
3483796,375,120,145,130,95,35,145,Auction
3484466,900,500,235,390,240,150,685,Auction
3484517,1150,800,194,570,320,250,344,Auction
3484715,1500,1085,305,125,90,35,455,Auction
3480507,650,365,175,95,70,25,25,Auction
3485368,800,405,274,495,275,220,274,Auction
3395420,575,225,244,75,50,25,194,Auction
3487238,325,105,130,5,5,0,150.45,Auction
3487874,400,140,154,25,5,20,154,Auction
3488376,2275,1790,375,1400,900,500,850,Auction
3488476,1175,715,354,175,140,35,279,Auction
3502845,425,120,199,140,120,20,99,Auction
3494089,750,405,190,180,120,60,65,Auction
3504031,1050,605,335,475,255,220,135,Auction
3504967,1125,640,375,335,185,150,650,Auction
3505653,400,165,110,50,25,25,160,Auction
3501509,800,465,225,215,115,100,475,Auction
3506989,550,270,214,200,165,35,114,Auction
3507282,625,320,199,90,65,25,474,Auction
3508418,625,300,215,255,155,100,840,Auction
3509704,775,390,229,160,100,60,754,Auction
3467856,1150,665,304,210,160,50,354,Auction
3510640,1075,625,270,250,200,50,695,Auction
3483054,600,295,195,40,20,20,95,Auction
3483289,600,295,195,295,245,50,170,Auction
3484740,1825,1300,419,845,505,340,894,Auction
3485275,900,545,245,110,50,60,1845,Auction
3485611,425,140,175,15,5,10,105,Auction
3486879,900,570,269,610,330,280,469,Auction
3486880,725,415,204,275,225,50,279,Auction
3488134,925,565,250,280,180,100,525,Auction
3488569,775,345,320,275,175,100,395,Auction
3489369,575,295,174,285,185,100,799,Auction
3489806,1275,820,345,380,230,150,320,Auction
3488751,1550,1100,270,340,190,150,2120,Auction
3441773,575,260,205,275,225,50,680,Auction
3491445,475,230,115,155,120,35,240,Auction
3487344,375,155,110,190,155,35,335,Auction
3487351,650,365,175,175,115,60,400,Auction
3487637,325,100,119,65,40,25,119,Auction
3485254,500,220,174,155,95,60,149,Auction
3488080,500,190,200,125,90,35,125,Auction
3480860,575,310,149,110,90,20,574,Auction
3488755,225,30,89,50,25,25,114,Auction
3489684,575,285,180,195,160,35,330,Auction
3490177,250,60,80,70,55,15,205,Auction
3490288,1100,675,315,170,150,20,165,Auction
3491113,375,120,115,125,65,60,90,Auction
3491738,600,315,175,450,230,220,425,Auction
3492449,1275,885,280,910,540,370,805,Auction
3493028,1050,535,409,270,235,35,409,Auction
3493635,1575,1125,344,1315,865,450,869,Auction
3494346,1700,1190,709,920,550,370,2409,Auction
3485615,550,230,210,275,225,50,310,Auction
3503167,1275,855,310,565,315,250,885,Auction
3503769,475,190,175,240,190,50,100,Auction
3465044,675,335,230,220,170,50,-445,Auction
3504656,1100,715,279,145,85,60,679,Auction
3508783,400,175,90,180,160,20,590,Auction
3509670,1975,1435,765,565,315,250,1290,Auction
3474511,500,190,200,145,110,35,-175,Auction
3473316,250,105,39,125,65,60,89,Auction
3475043,1525,1105,310,170,150,20,585,Auction
3471040,925,520,235,225,190,35,135,Auction
3472180,575,290,175,190,155,35,0,Auction
3382789,1125,730,230,80,55,25,155,Auction
3475452,650,355,174,240,155,85,224,Auction
3472069,1700,1185,405,145,125,20,-495,Auction
3475920,500,215,175,300,165,135,250,Auction
3476315,1050,590,644,200,100,100,144,Auction
3476656,1025,670,245,350,200,150,320,Auction
3477660,1075,585,384,840,500,340,1909,Auction
3477919,2250,1870,270,815,475,340,2420,Auction
3478753,550,205,235,100,65,35,210,Auction
3475179,525,220,199,185,125,60,199,Auction
3479932,950,465,379,270,170,100,104,Auction
3480268,525,240,175,310,160,150,270.35,Auction
3480259,400,160,134,155,120,35,134,Auction
3480293,700,305,289,135,100,35,289,Auction
3481770,1225,875,240,595,345,250,215,Auction
3482174,300,110,80,107,45,62,146.75,Auction
3507860,525,215,200,180,145,35,175,Auction
3508796,1650,1220,320,815,475,340,520,Auction
3509053,725,350,265,190,155,35,240,Auction
3509589,500,195,244,100,40,60,244,Auction
3509823,825,465,204,330,255,75,229,Auction
3509830,300,80,110,75,50,25,85,Auction
3512097,850,485,259,275,225,50,709,Auction
3513240,275,55,90,35,15,20,90,Auction
3513967,275,70,75,105,45,60,150,Auction
3514067,525,195,219,145,110,35,444,Auction
3514476,575,255,214,170,135,35,114,Auction
3486756,550,245,199,70,45,25,299,Auction
3486773,2575,1900,469,1325,875,450,894,Auction
3486939,1375,770,469,385,235,150,369,Auction
3489347,1575,1155,310,800,460,340,425,Auction
3489913,1000,545,345,810,470,340,595,Auction
3490066,400,140,154,155,95,60,154,Auction
3490266,900,435,289,250,200,50,289,Auction
3490330,650,355,174,250,200,50,424,Auction
3479085,950,585,255,135,115,20,655,Auction
3481062,225,60,59,45,25,20,9,Auction
3481269,625,340,175,125,65,60,315,Auction
3481655,1625,1230,285,1040,940,100,60,Auction
3482312,3650,2990,550,650,370,280,3500,Auction
3482848,1325,865,354,400,345,55,729,Auction
3444158,800,430,264,285,185,100,214,Auction
3483977,900,520,270,180,120,60,370,Auction
3484420,450,170,174,167,130,37,124,Auction
3485063,1375,905,364,470,360,110,439,Auction
3485899,775,385,280,500,375,125,155,Auction
3486499,575,290,175,150,115,35,325,Auction
3470023,725,390,184,215,165,50,759,Auction
3472147,1025,590,284,680,400,280,109,Auction
3490484,375,135,105,168,110,58,130,Auction
3490567,300,100,90,140,80,60,65,Auction
3490667,825,530,189,430,320,110,614,Auction
3490818,750,430,210,75,50,25,460,Auction
3487674,575,290,175,350,275,75,50,Auction
3491418,1025,620,299,105,85,20,574,Auction
3491869,275,75,94,120,60,60,269,Auction
3492654,400,170,124,90,65,25,724,Auction
3493539,525,240,175,180,120,60,150,Auction
3495028,350,120,140,145,110,35,65,Auction
3496064,1000,550,334,570,320,250,509,Auction
3496283,525,270,149,310,235,75,149,Auction
3479695,1975,1495,370,995,625,370,145,Auction
3481049,400,165,125,135,100,35,125,Auction
3481768,325,130,85,165,105,60,-15,Auction
3481899,575,240,244,160,140,20,244,Auction
3484175,850,395,345,400,180,220,170,Auction
3485562,3350,2740,504,2165,1515,650,3154,Auction
3486447,900,525,269,365,290,75,244,Auction
3466978,975,535,269,210,160,50,269,Auction
3499914,1200,735,285,135,100,35,635,Auction
3504165,825,380,335,200,100,100,230.45,Auction
3504251,1275,820,345,325,175,150,820,Auction
3504608,275,65,100,45,25,20,100,Auction
3425499,475,190,175,65,45,20,1295.35,Auction
3506780,1950,1375,465,930,560,370,665,Auction
3486274,400,145,115,220,120,100,160.45,Auction
3508295,2475,1680,689,1085,685,400,864,Auction
3509638,1600,1180,314,1145,745,400,314,Auction
3509681,975,580,265,415,195,220,290,Auction
3472544,1025,660,259,690,410,280,134,Auction
3473382,3775,3100,565,2310,1660,650,690,Auction
3461214,650,365,175,150,115,35,141.75,Auction
3473875,575,255,214,170,150,20,64,Auction
3473943,625,335,184,190,155,35,59,Auction
3457495,775,405,214,170,110,60,214,Auction
3449207,1075,605,290,410,300,110,515,Auction
3471578,625,345,135,435,325,110,60,Auction
3475386,2725,2210,409,1025,625,400,409,Auction
3475420,275,120,49,150,115,35,49,Auction
3476390,1600,1065,340,205,115,90,90,Auction
3479130,350,150,90,60,35,25,90,Auction
3479330,950,635,205,60,35,25,255,Auction
3471458,425,145,174,150,130,20,-1,Auction
3472194,725,355,264,225,190,35,264,Auction
3472260,1000,570,394,600,320,280,494,Auction
3472553,450,190,130,120,85,35,-20,Auction
3473389,425,120,199,120,60,60,74,Auction
3473725,300,95,75,80,55,25,75,Auction
3474259,600,270,209,155,120,35,159,Auction
3466035,375,150,90,75,50,25,140,Auction
3473430,425,115,200,50,25,25,1025,Auction
3477633,725,420,199,510,260,250,199,Auction
3477769,1425,945,370,490,380,110,945,Auction
3505572,250,40,85,65,40,25,260,Auction
3506793,875,455,340,420,200,220,115,Auction
3405717,350,180,60,60,35,25,185,Auction
3513111,250,100,40,85,65,20,65,Auction
3484506,250,65,75,55,30,25,125,Auction
3447959,400,175,115,140,80,60,165,Auction
3485342,350,155,85,85,65,20,135,Auction
3485678,300,95,75,10,5,5,0,Auction
3487749,375,190,79,150,115,35,929,Auction
3487750,350,135,109,115,55,60,159,Auction
3489471,1150,660,340,405,295,110,890,Auction
3489372,1425,920,344,725,415,310,344,Auction
3492280,1250,835,305,335,185,150,205,Auction
3493165,450,140,200,95,70,25,100,Auction
3496566,375,120,139,163,115,48,464,Auction
3511257,275,115,50,150,115,35,75,Auction
3489044,575,280,189,110,50,60,439,Auction
3515265,1350,855,385,675,395,280,285,Auction
3513193,1475,915,360,430,375,55,335,Auction
3515550,425,140,175,123,65,58,300,Auction
3515937,1125,620,395,120,85,35,95,Auction
3515901,1250,835,305,620,340,280,955,Auction
3516586,675,355,199,245,205,40,199,Auction
3518594,475,165,200,140,80,60,250,Auction
3494151,475,195,174,220,170,50,149,Auction
3496873,1300,845,349,910,540,370,199,Auction
3496910,600,320,174,115,80,35,874,Auction
3497224,325,105,94,125,90,35,144,Auction
3497659,550,235,209,190,130,60,34,Auction
3498745,2400,1935,359,1275,825,450,4759,Auction
3499381,900,505,419,170,110,60,319,Auction
3499581,1250,860,280,430,375,55,280,Auction
3494802,1275,855,250,250,215,35,475,Auction
3500353,1375,1010,590,210,110,100,215,Auction
3501154,575,255,214,335,185,150,139,Auction
3495393,875,530,239,420,200,220,964,Auction
3473983,625,345,135,200,150,50,110,Auction
3495768,1050,670,270,190,130,60,570,Auction
3495843,325,90,129,70,45,25,254,Auction
3498265,700,375,219,365,215,150,419,Auction
3491767,400,120,149,105,70,35,249,Auction
3499187,700,375,174,180,120,60,174,Auction
3497890,1100,570,339,655,375,280,289,Auction
3424997,1000,545,345,280,180,100,845,Auction
3497758,800,470,179,450,230,220,504,Auction
3482867,625,285,234,175,115,60,234,Auction
3483833,175,10,54,60,35,25,54,Auction
3484544,1075,690,275,640,360,280,350,Auction
3485982,2075,1490,475,940,570,370,950,Auction
3486518,2825,2285,430,1070,670,400,1155,Auction
3487118,400,120,144,150,115,35,144,Auction
3487377,825,420,295,210,160,50,220,Auction
3487420,750,385,255,210,160,50,655,Auction
3487811,300,105,75,125,70,55,75,Auction
3489951,350,120,100,59,35,24,50,Auction
3490930,825,460,255,450,230,220,355,Auction
3515248,475,220,145,200,150,50,420,Auction
3519347,675,350,215,325,175,150,590,Auction
3520226,450,165,190,125,65,60,890,Auction
3521621,625,295,220,175,115,60,795,Auction
3499755,1600,1145,275,1345,895,450,375,Auction
3511269,575,260,200,270,220,50,425,Auction
3511401,1150,700,344,850,510,340,344,Auction
3511494,550,240,200,190,170,20,125,Auction
3511576,600,325,165,165,105,60,115,Auction
3513116,300,90,94,10,5,5,194,Auction
3513784,2850,2310,430,785,475,310,1980,Auction
3515345,700,410,184,330,180,150,434,Auction
3516456,750,430,179,270,235,35,329,Auction
3517085,775,370,295,465,245,220,920,Auction
3510690,1725,1260,285,835,495,340,510,Auction
3517135,925,495,320,765,455,310,245,Auction
3492487,4075,3355,610,2090,1440,650,1447.75,Auction
3492755,350,130,90,130,70,60,140,Auction
3494427,1250,860,280,140,120,20,730,Auction
3494525,550,230,210,130,95,35,135,Auction
3495414,1575,1120,345,1080,680,400,120,Auction
3495461,1150,750,290,160,100,60,1190,Auction
3396091,1100,625,369,270,170,100,219,Auction
3498303,675,370,195,60,35,25,1715.35,Auction
3498937,325,105,90,100,40,60,140,Auction
3499158,300,100,74,50,25,25,174,Auction
3491423,275,120,49,150,115,35,74,Auction
3492057,375,140,129,115,55,60,204,Auction
3492168,975,580,285,395,245,150,710,Auction
3492266,825,490,229,600,320,280,104,Auction
3492734,625,340,175,150,90,60,300,Auction
3492836,1150,660,380,395,245,150,205,Auction
3493661,675,350,215,245,145,100,465,Auction
3496137,300,95,95,80,55,25,245,Auction
3496746,900,545,260,525,275,250,360,Auction
3496869,675,330,200,80,60,20,150,Auction
3497307,1250,800,344,850,510,340,694,Auction
3497414,700,340,254,455,235,220,104,Auction
3518807,1450,1015,329,200,150,50,2179,Auction
3519207,200,20,74,5,5,0,99,Auction
3521386,450,205,114,315,165,150,364,Auction
3522322,475,165,200,120,85,35,25,Auction
3519450,1275,860,195,945,575,370,520,Auction
3518732,725,390,229,210,175,35,104,Auction
3524144,1675,1165,404,400,345,55,1329,Auction
3526977,750,390,250,355,205,150,250,Auction
3488064,1075,585,384,605,325,280,1309,Auction
3489357,1050,565,379,650,370,280,429,Auction
3490872,1025,565,350,430,210,220,325,Auction
3491522,525,245,174,200,150,50,174,Auction
3491722,925,515,304,420,310,110,279,Auction
3492201,250,65,75,45,25,20,75,Auction
3493008,2050,1505,435,785,475,310,985,Auction
3493487,850,440,300,325,175,150,1000,Auction
3493744,750,430,210,325,175,150,1060,Auction
3494073,250,100,40,130,95,35,140,Auction
3494387,875,545,220,150,115,35,170,Auction
3502863,500,215,190,185,150,35,65,Auction
3503106,775,390,224,210,160,50,699,Auction
3504067,600,265,225,80,55,25,125,Auction
3504467,575,220,200,120,100,20,200,Auction
3504953,500,220,194,270,200,70,244,Auction
3505446,1050,635,305,190,130,60,405,Auction
3505621,350,115,104,135,75,60,179,Auction
3505728,600,265,200,140,105,35,175,Auction
3505735,400,155,135,200,150,50,460,Auction
3505928,1000,545,345,340,190,150,395,Auction
3506339,800,425,265,175,155,20,215,Auction
3506532,550,230,210,125,65,60,235,Auction
3487465,325,160,59,175,140,35,134,Auction
3487383,2350,1685,559,1025,625,400,1909,Auction
3487783,2150,1390,654,165,145,20,1104,Auction
3488320,4325,3570,594,3550,2750,800,2369,Auction
3489723,825,505,175,425,370,55,175,Auction
3491545,625,300,219,295,195,100,94,Auction
3491710,1000,595,295,179,120,59,845,Auction
3492060,700,350,219,290,190,100,919,Auction
3493800,1175,800,269,655,375,280,269,Auction
3490842,675,355,214,125,90,35,214,Auction
3509419,1325,900,275,605,325,280,850,Auction
3515452,475,170,199,180,120,60,124,Auction
3525061,600,320,174,165,105,60,174,Auction
3472351,1150,720,324,265,215,50,124,Auction
3444573,700,390,200,80,55,25,600,Auction
3528856,850,550,190,230,130,100,540,Auction
3491560,850,440,300,400,290,110,275,Auction
3491895,275,80,89,70,45,25,89,Auction
3492163,575,260,205,205,155,50,0,Auction
3492781,525,220,199,205,155,50,374,Auction
3492832,600,290,204,175,155,20,304,Auction
3493049,400,135,140,135,100,35,65,Auction
3494218,575,255,214,210,175,35,214,Auction
3495104,1150,755,289,590,340,250,289,Auction
3495286,1075,625,340,175,115,60,40,Auction
3495890,1250,840,304,415,195,220,554,Auction
3496793,1500,985,409,1355,905,450,409,Auction
3497176,925,495,444,235,185,50,444,Auction
3497508,850,420,255,555,305,250,1900.35,Auction
3497711,1300,840,380,760,450,310,312.75,Auction
3496383,1475,1030,335,250,150,100,610,Auction
3497249,800,405,285,245,145,100,335,Auction
3497500,475,190,175,150,90,60,425,Auction
3498506,475,190,200,85,65,20,175,Auction
3498655,275,85,80,80,55,25,55,Auction
3499642,825,465,254,315,165,150,1429,Auction
3497536,750,395,199,405,185,220,1349,Auction
3500478,1400,995,299,400,345,55,299,Auction
3501914,1125,695,430,600,320,280,180,Auction
3502299,200,25,54,30,10,20,154,Auction
3491618,900,550,194,875,535,340,544,Auction
3502999,450,190,150,265,165,100,325,Auction
3530592,4225,3480,635,650,370,280,2710,Auction
3535906,1975,1435,430,825,485,340,1205,Auction
3536057,1300,780,414,670,390,280,439,Auction
3537042,750,430,179,460,420,40,179,Auction
3365986,750,370,215,125,65,60,440,Auction
3480636,1050,620,324,650,370,280,324,Auction
3480691,1250,785,355,855,515,340,905,Auction
3480895,775,450,275,160,140,20,150,Auction
3481168,825,485,230,170,110,60,230,Auction
3481738,1075,745,224,255,155,100,99,Auction
3460069,1000,680,179,160,140,20,879,Auction
3480836,1875,1285,385,760,450,310,510,Auction
3417855,250,70,70,5,5,0,20,Auction
3484678,350,120,120,50,30,20,240.7,Auction
3485146,925,635,184,660,520,140,59,Auction
3485805,600,315,175,265,165,100,300,Auction
3485205,475,165,200,145,85,60,125,Auction
3486141,500,245,149,255,205,50,149,Auction
3487018,625,365,150,185,125,60,1575,Auction
3501353,500,195,199,180,160,20,399,Auction
3501939,725,440,175,200,150,50,200,Auction
3503075,675,350,175,125,90,35,250,Auction
3462163,550,245,199,160,100,60,224,Auction
3504561,500,195,199,130,75,55,299,Auction
3474445,350,150,74,160,140,20,74,Auction
3506670,1100,735,259,945,575,370,459,Auction
3506734,375,130,139,60,35,25,139,Auction
3507805,200,25,54,25,5,20,104,Auction
3508056,2600,2000,490,735,425,310,3390,Auction
3500403,1400,830,374,125,90,35,1574,Auction
3508941,725,445,174,160,140,20,249,Auction
3509177,525,240,175,140,80,60,175,Auction
3509241,475,190,175,140,105,35,50,Auction
3505873,625,335,175,73,55,18,850,Auction
3505843,750,445,195,380,305,75,245,Auction
3507096,250,60,80,35,15,20,125.45,Auction
3506109,1925,1355,374,1120,720,400,1449,Auction
3507745,575,260,205,115,80,35,255,Auction
3510587,2650,2105,439,1725,1175,550,2089,Auction
3486453,925,565,200,430,210,220,100,Auction
3511976,275,55,110,65,40,25,85,Auction
3512695,375,185,80,200,150,50,151.37,Auction
3513146,775,450,219,270,170,100,244,Auction
3513246,875,525,240,200,100,100,115,Auction
3548640,1625,1250,214,735,425,310,689,Auction
3549295,500,195,199,140,80,60,699,Auction
3549376,600,295,200,190,155,35,250,Auction
3477867,1600,1225,265,520,270,250,515,Auction
3477967,900,430,360,180,160,20,435,Auction
3478246,600,290,214,250,150,100,314,Auction
3478669,1450,1040,300,1020,620,400,1100,Auction
3479246,375,135,105,205,155,50,80,Auction
3479741,425,185,105,165,105,60,105,Auction
3479882,2025,1565,350,965,595,370,575,Auction
3480418,1675,1130,435,550,425,125,310,Auction
3469786,800,425,214,475,255,220,414,Auction
3456218,950,590,204,245,210,35,104,Auction
3481890,1025,570,319,255,155,100,294,Auction
3482149,550,285,210,275,225,50,160,Auction
3482247,575,250,215,270,235,35,165,Auction
3479182,1225,695,339,660,380,280,342.5,Auction
3476840,750,370,219,285,235,50,219,Auction
3483585,900,515,279,550,485,65,279,Auction
3483628,725,440,315,200,150,50,315,Auction
3485264,1150,775,265,840,500,340,1865,Auction
3485455,750,335,309,280,230,50,84,Auction
3516017,1200,760,269,825,485,340,269,Auction
3517404,1100,565,340,175,140,35,1290,Auction
3517672,875,575,174,450,230,220,999,Auction
3518025,625,320,199,135,75,60,199,Auction
3518076,775,410,255,265,215,50,455,Auction
3518527,650,330,210,150,115,35,110,Auction
3518761,650,300,200,210,160,50,100,Auction
3516923,4000,3245,519,3210,2410,800,2519,Auction
3521335,975,480,335,690,450,240,1010,Auction
3522301,1075,640,329,390,240,150,479,Auction
3522352,3800,3050,521.25,945,575,370,121.25,Auction
3523556,625,335,184,120,100,20,184,Auction
3524092,525,240,175,235,185,50,500,Auction
3523793,325,105,114,165,105,60,264,Auction
3525063,250,50,94,55,35,20,94,Auction
3526778,1650,1190,350,860,520,340,950,Auction
3527837,675,335,230,65,40,25,705,Auction
3529250,300,100,94,50,25,25,94,Auction
3531058,600,320,174,170,135,35,174,Auction
3532251,600,265,225,195,135,60,125,Auction
3511610,350,135,109,15,5,10,109,Auction
3512346,550,245,199,195,160,35,549,Auction
3512632,600,265,200,225,175,50,200,Auction
3506480,850,455,225,315,180,135,175,Auction
3513139,525,240,175,255,205,50,300,Auction
3514125,800,505,185,235,135,100,480.35,Auction
3514468,2175,1695,374,1500,1000,500,499,Auction
3421455,400,165,125,90,65,25,275,Auction
3503479,1050,590,284,250,200,50,284,Auction
3505001,225,80,39,20,10,10,114,Auction
3515604,375,135,119,100,65,35,244,Auction
3515740,300,75,110,75,55,20,435,Auction
3516240,725,370,199,300,225,75,199,Auction
3516819,750,395,199,165,130,35,274,Auction
3517119,975,485,309,260,210,50,334,Auction
3553220,1150,750,290,670,390,280,1240,Auction
3535861,375,125,115,120,60,60,215,Auction
3537197,450,165,230,95,70,25,230,Auction
3538274,1050,720,220,150,90,60,470,Auction
3540739,1025,670,415,560,310,250,1040,Auction
3499133,850,465,275,190,130,60,1425,Auction
3499166,850,525,215,400,180,220,240,Auction
3499180,2075,1635,330,625,345,280,1605,Auction
3499183,1075,655,310,415,195,220,285,Auction
3498261,1625,1085,345,185,125,60,370,Auction
3500434,350,135,89,85,60,25,489,Auction
3500584,1775,1310,419,1120,720,400,944,Auction
3502873,500,220,174,105,45,60,374,Auction
3503846,575,280,189,325,250,75,114,Auction
3504328,675,385,180,140,80,60,155,Auction
3504728,750,430,210,585,335,250,706.37,Auction
3504999,725,350,205,245,195,50,205,Auction
3504996,1625,1120,395,1425,925,500,1270,Auction
3505413,275,55,105,25,5,20,30,Auction
3481182,975,535,334,475,255,220,159,Auction
3490430,625,315,200,125,90,35,270.35,Auction
3490494,300,100,94,155,95,60,94,Auction
3491923,675,390,175,375,300,75,900,Auction
3492268,375,150,100,135,100,35,25,Auction
3492927,1025,505,350,465,245,220,125,Auction
3492961,450,140,200,90,65,25,400,Auction
3493493,1125,695,320,515,265,250,545,Auction
3495276,1675,1050,519,875,535,340,1744,Auction
3495301,1100,730,260,190,155,35,410,Auction
3527581,1025,700,215,515,265,250,290,Auction
3527874,625,315,200,145,85,60,200,Auction
3491774,775,465,179,75,55,20,204,Auction
3530028,650,350,190,365,290,75,165,Auction
3531614,750,370,215,430,210,220,315,Auction
3495676,525,220,199,204,155,49,124,Auction
3490664,775,450,215,200,100,100,415,Auction
3496271,725,340,279,345,195,150,29,Auction
3498977,1050,670,270,645,365,280,1120,Auction
3499284,650,355,274,175,115,60,174,Auction
3499811,650,350,190,180,145,35,740,Auction
3478355,475,165,200,125,90,35,225,Auction
3500313,675,395,174,275,225,50,399,Auction
3486677,2375,1820,835,460,240,220,210,Auction
3499375,525,245,174,210,160,50,204,Auction
3500090,375,135,130,80,60,20,155,Auction
3500175,2100,1345,645,890,550,340,195,Auction
3485969,800,405,289,310,160,150,289,Auction
3486990,1475,1030,335,370,220,150,510,Auction
3501060,300,95,75,115,55,60,25,Auction
3501179,2275,1725,809,1415,915,500,684,Auction
3417164,850,420,260,225,125,100,610,Auction
3500124,375,120,119,75,50,25,119,Auction
3503936,875,505,214,250,200,50,739,Auction
3507127,500,190,200,180,160,20,525,Auction
3498950,700,360,234,340,190,150,284,Auction
3500081,450,165,175,170,135,35,671.25,Auction
3500213,500,220,174,245,210,35,324,Auction
3500422,250,105,39,90,65,25,189,Auction
3500490,2125,1695,320,990,620,370,1141.62,Auction
3502119,575,265,200,145,85,60,109,Auction
3498116,400,135,125,75,50,25,100,Auction
3503889,1425,800,515,905,535,370,290,Auction
3503766,725,385,195,525,275,250,1170,Auction
3504098,3725,3055,560,1725,1175,550,1535,Auction
3504600,1075,550,415,240,190,50,1040,Auction
3504668,3450,2820,520,1020,620,400,720,Auction
3504927,3000,2265,625,640,360,280,425,Auction
3505161,850,485,259,245,210,35,1209,Auction
3462175,650,365,160,145,85,60,260,Auction
3504393,325,115,84,135,100,35,359,Auction
3504734,650,355,189,170,150,20,639,Auction
3495374,850,485,209,385,310,75,709,Auction
3507610,1275,860,309,535,285,250,309,Auction
3508103,350,110,130,75,55,20,105,Auction
3509975,1050,605,630,350,200,150,380,Auction
3497476,900,505,519,270,170,100,319,Auction
3464869,1175,740,264,760,495,265,639,Auction
3498062,400,165,100,105,70,35,400,Auction
3499012,875,455,310,520,270,250,356.37,Auction
3499548,1525,1155,264,775,465,310,639,Auction
3495336,675,315,250,190,155,35,300,Auction
3499901,1325,625,521.25,435,325,110,396.25,Auction
3502206,1250,865,264,50,30,20,114,Auction
3502441,525,245,174,142,105,37,649,Auction
3501138,350,130,90,130,110,20,140,Auction
3538391,675,315,200,90,65,25,225,Auction
3525509,875,455,250,355,205,150,475,Auction
3540506,2200,1590,504,1450,950,500,3204,Auction
3540524,300,115,79,150,115,35,1304,Auction
3543221,775,450,215,525,275,250,140,Auction
3486434,1425,990,329,630,350,280,404,Auction
3483992,700,405,175,260,210,50,471.62,Auction
3465208,525,245,174,245,195,50,199,Auction
3487363,1250,860,280,795,485,310,1230,Auction
3488163,925,515,244,405,185,220,244,Auction
3488765,650,325,219,555,305,250,1169,Auction
3489644,1000,565,325,250,200,50,250,Auction
3460962,575,225,199,190,155,35,424,Auction
3491514,1150,810,185,360,230,130,131.37,Auction
3491571,1225,755,319,860,520,340,194,Auction
3492114,425,140,215,145,110,35,65,Auction
3492416,575,255,199,173,140,33,474,Auction
3492507,1175,680,415,350,275,75,990,Auction
3493488,700,415,175,195,160,35,125,Auction
3514784,375,190,79,195,135,60,604,Auction
3515318,375,150,115,180,145,35,340,Auction
3516503,850,530,214,250,150,100,764,Auction
3477629,2000,1590,300,1185,785,400,1250,Auction
3520264,1200,855,235,490,270,220,485,Auction
3509947,1075,580,385,850,510,340,760,Auction
3510808,850,480,260,265,165,100,285,Auction
3512262,600,270,224,145,85,60,174,Auction
3512973,625,335,180,125,90,35,180,Auction
3513105,900,435,359,120,100,20,559,Auction
3514763,1525,960,459,815,475,340,334,Auction
3515245,600,280,210,130,110,20,185,Auction
3514220,700,350,204,350,275,75,204,Auction
3516231,2525,2040,379,2065,1415,650,354,Auction
3525143,750,395,249,250,215,35,299,Auction
3526147,575,290,175,150,115,35,750,Auction
3527151,1725,1120,495,625,345,280,420,Auction
3528253,1600,1150,344,770,460,310,644,Auction
3528921,850,440,385,250,200,50,510,Auction
3529942,575,295,174,40,20,20,349,Auction
3531563,925,510,305,400,345,55,680,Auction
3523505,875,415,280,250,200,50,180,Auction
3504146,1000,575,315,370,220,150,65,Auction
3495353,1150,750,235,715,405,310,985,Auction
3508507,475,190,175,155,120,35,100,Auction
3508657,1125,695,320,605,325,280,745,Auction
3509375,350,180,115,77,50,27,340,Auction
3510312,900,475,250,335,185,150,950,Auction
3511230,825,380,335,225,175,50,260,Auction
3511954,2900,2310,484,1165,765,400,284,Auction
3511945,525,215,200,180,120,60,325,Auction
3512788,2000,1560,330,1645,1095,550,1130,Auction
3511018,1050,535,329,645,365,280,179,Auction
3517302,350,115,119,80,60,20,269,Auction
3518497,325,110,105,100,40,60,205,Auction
3474710,650,300,225,265,165,100,250,Auction
3486399,675,320,199,200,150,50,224,Auction
3495866,800,465,225,175,115,60,575,Auction
3496488,300,75,110,60,35,25,235,Auction
3498167,975,610,259,405,185,220,259,Auction
3498560,1125,645,299,565,315,250,174,Auction
3499017,700,370,185,235,150,85,685,Auction
3499317,2550,1870,455,2065,1415,650,2155,Auction
3500296,1475,890,479,870,530,340,604,Auction
3500689,725,370,199,565,315,250,449,Auction
3501132,2800,2120,455,1730,1180,550,505,Auction
3502254,1225,780,335,250,200,50,110,Auction
3502318,275,85,94,20,10,10,94,Auction
3545536,2825,2290,425,530,280,250,4700,Auction
3550334,975,625,240,110,50,60,115,Auction
3513770,575,235,230,190,155,35,80,Auction
3514924,350,135,94,100,65,35,194,Auction
3516664,625,345,135,255,205,50,1310,Auction
3518536,300,80,90,5,5,0,85.35,Auction
3507486,675,335,230,155,95,60,150.35,Auction
3519454,500,215,175,105,45,60,475,Auction
3522250,1000,545,345,730,420,310,270,Auction
3522339,2200,1760,340,1715,1165,550,340,Auction
3522650,325,105,114,105,45,60,89,Auction
3523352,300,140,50,55,35,20,75,Auction
3526692,1050,585,355,260,160,100,1855,Auction
3527189,1225,840,275,725,415,310,2900,Auction
3527355,375,170,109,76,50,26,434,Auction
3503340,600,320,244,167,105,62,244,Auction
3465007,500,190,200,90,65,25,50,Auction
3506212,1625,1120,399,1210,760,450,574,Auction
3507184,1225,655,565,185,125,60,490,Auction
3508070,1000,495,395,190,155,35,195,Auction
3532997,650,315,229,290,190,100,429,Auction
3533767,425,120,199,125,70,55,724,Auction
3534737,2975,2420,1665,540,290,250,740,Auction
3521225,750,385,290,330,180,150,165,Auction
3522293,700,335,255,220,185,35,330,Auction
3523015,300,85,85,100,65,35,160,Auction
3523548,625,300,199,420,200,220,199,Auction
3490927,2650,2145,319,1590,1090,500,469,Auction
3501352,900,565,225,245,195,50,300,Auction
3526156,1000,575,255,505,255,250,405,Auction
3528028,1025,700,265,225,175,50,390,Auction
3494245,625,335,179,165,105,60,-21,Auction
3489735,1975,1500,294,1365,915,450,1219,Auction
3496453,525,215,220,180,110,70,145,Auction
3496730,525,245,239,125,105,20,364,Auction
3497689,500,220,204,120,60,60,154,Auction
3464472,550,270,174,250,150,100,124,Auction
3499461,875,480,289,330,180,150,114,Auction
3501231,725,370,219,340,265,75,44,Auction
3522709,900,430,290,445,225,220,115,Auction
3533946,1825,1210,564,1020,620,400,439,Auction
3534073,375,125,80,103,45,58,180,Auction
3511199,2025,1545,370,1295,845,450,183,Auction
3511750,1900,1465,329,280,180,100,929,Auction
3512049,750,430,210,175,155,20,285,Auction
3512200,400,210,80,150,115,35,80,Auction
3513536,2575,2020,310,1490,1090,400,935,Auction
3491358,275,70,75,45,25,20,175,Auction
3514607,600,265,225,245,145,100,325,Auction
3514958,400,140,154,60,35,25,104,Auction
3515444,475,190,175,95,70,25,275,Auction
3510063,750,395,199,151,115,36,149,Auction
3516029,1575,1155,310,1090,690,400,785,Auction
3516079,825,420,315,260,210,50,240,Auction
3516594,1150,665,379,765,455,310,829,Auction
3517765,850,510,234,140,120,20,559,Auction
3521349,350,185,59,150,130,20,309,Auction
3522119,975,655,210,410,190,220,535,Auction
3507045,1325,730,489,305,155,150,464,Auction
3525378,1475,945,424,770,460,310,1049,Auction
3525429,550,260,180,245,210,35,1130,Auction
3525644,950,530,310,525,275,250,660,Auction
3525578,1250,675,375,135,75,60,425,Auction
3523170,2250,1540,500,1420,920,500,900,Auction
3526999,675,315,250,25,5,20,825,Auction
3490782,425,140,175,120,60,60,100,Auction
3528386,675,335,199,435,215,220,1224,Auction
3529122,725,350,265,140,80,60,365,Auction
3505434,375,135,119,125,90,35,194,Auction
3509748,2025,1545,319,775,465,310,319,Auction
3510314,375,120,149,125,90,35,399,Auction
3495644,2525,2035,305,830,490,340,1080,Auction
3491257,525,240,175,155,120,35,625,Auction
3513317,500,195,199,10,5,5,324,Auction
3507897,1500,1060,334,935,565,370,684,Auction
3509650,1150,715,260,540,290,250,710,Auction
3511956,525,245,239,225,175,50,214,Auction
3512411,675,335,234,210,160,50,259,Auction
3513126,625,285,230,100,40,60,380,Auction
3513798,1125,585,430,295,195,100,1705,Auction
3513811,2100,1515,479,745,435,310,129,Auction
3514130,2150,1670,374,1060,660,400,624,Auction
3514147,625,300,215,80,55,25,215,Auction
3514279,450,140,200,115,55,60,250,Auction
3505463,700,355,200,420,220,200,95.35,Auction
3507068,600,325,165,505,255,250,440,Auction
3495035,700,325,214,150,115,35,414,Auction
3508407,550,260,175,180,160,20,325,Auction
3508740,1125,675,340,695,415,280,665,Auction
3509825,1425,945,365,660,380,280,440,Auction
3510161,1475,900,405,505,255,250,280,Auction
3510662,800,505,185,430,375,55,310,Auction
3514355,825,505,295,490,270,220,670,Auction
3514705,975,580,285,520,270,250,710,Auction
3515410,1400,855,439,195,135,60,189,Auction
3538528,900,590,240,270,170,100,240,Auction
3542374,1225,780,339,760,450,310,1514,Auction
3543663,375,135,130,85,60,25,680,Auction
3545067,550,245,199,315,165,150,549,Auction
3517708,2650,2105,394,1230,780,450,1044,Auction
3519746,1600,1015,475,1150,750,400,425,Auction
3520312,2325,1660,559,860,520,340,834,Auction
3521767,475,230,135,305,230,75,585,Auction
3522218,475,170,199,170,150,20,124,Auction
3522954,900,595,199,375,225,150,349,Auction
3516967,550,265,175,265,165,100,300,Auction
3516985,900,480,191.25,235,200,35,216.25,Auction
3517896,550,265,175,115,95,20,175,Auction
3519232,1800,1185,505,1360,910,450,855,Auction
3520168,375,135,130,125,90,35,395,Auction
3520486,600,300,179,275,225,50,104,Auction
3520393,925,450,294,485,265,220,294,Auction
3519102,1700,1105,489,930,560,370,589,Auction
3520323,675,355,214,150,115,35,339,Auction
3522360,325,125,74,128,70,58,124,Auction
3523596,575,305,160,155,95,60,2085,Auction
3495887,975,550,254,505,255,250,304,Auction
3524482,675,285,284,210,160,50,459,Auction
3512479,625,285,204,190,155,35,179,Auction
3516032,375,150,94,185,150,35,94,Auction
3516325,475,165,204,150,115,35,829,Auction
3517763,1100,565,425,500,375,125,1075,Auction
3518095,400,170,129,125,90,35,179,Auction
3520210,925,565,250,440,220,220,565,Auction
3520567,500,215,195,185,125,60,395,Auction
3521707,725,375,240,280,180,100,240,Auction
3521941,675,335,230,190,130,60,330,Auction
3522414,500,190,200,215,165,50,425,Auction
3528427,575,295,174,180,160,20,549,Auction
3530014,250,65,79,15,5,10,204,Auction
3536115,650,315,229,255,205,50,329,Auction
3511335,575,290,175,100,65,35,100,Auction
3512221,675,355,214,275,175,100,239,Auction
3512607,400,145,115,65,40,25,315,Auction
3513114,700,335,205,415,195,220,155,Auction
3514729,1200,760,334,400,180,220,459,Auction
3517058,350,135,90,110,55,55,90,Auction
3518205,200,30,59,20,10,10,59,Auction
3518305,1650,1090,450,965,595,370,2096.37,Auction
3502922,950,450,265,335,185,150,2715,Auction
3519891,975,610,259,210,160,50,534,Auction
3524135,3200,2610,480,175,140,35,2680,Auction
3525007,575,225,244,150,130,20,169,Auction
3515960,825,450,219,395,245,150,294,Auction
3516296,525,240,175,115,55,60,175,Auction
3516645,375,150,115,200,100,100,140,Auction
3517014,225,45,70,70,45,25,95,Auction
3517581,375,185,80,120,60,60,180,Auction
3478392,550,265,175,275,225,50,275,Auction
3519422,1075,625,440,205,155,50,1315,Auction
3437880,700,405,185,310,160,150,135,Auction
3521979,400,145,145,45,25,20,1095,Auction
3524133,400,215,79,160,100,60,79,Auction
3531443,3500,2865,525,1625,1075,550,125,Auction
3522541,850,440,300,270,220,50,275,Auction
3523911,450,145,199,135,100,35,149,Auction
3525349,2100,1555,439,430,375,55,139,Auction
3526285,1000,550,424,995,810,185,174,Auction
3527396,350,125,119,185,125,60,194,Auction
3527855,725,355,229,360,230,130,404,Auction
3527898,900,525,269,430,210,220,919,Auction
3530565,925,585,330,180,120,60,1055,Auction
3527761,375,185,145,40,20,20,265.35,Auction
3528212,1250,840,304,420,200,220,304,Auction
3520414,625,335,179,220,170,50,104,Auction
3529825,575,255,214,195,135,60,464,Auction
3528987,1100,660,334,555,305,250,1584,Auction
3474052,800,445,245,325,175,150,145,Auction
3527799,975,560,399,535,285,250,474,Auction
3528885,525,215,200,230,130,100,225,Auction
3529642,700,325,239,230,145,85,264,Auction
3529660,975,560,305,110,90,20,1180,Auction
3528149,525,215,200,225,175,50,175,Auction
3532679,525,220,199,220,185,35,174,Auction
3532811,950,605,190,445,225,220,790,Auction
3519573,400,170,124,175,155,20,674,Auction
3519759,1800,1240,450,580,330,250,800,Auction
3520302,350,185,59,200,150,50,234,Auction
3520938,850,470,244,215,180,35,394,Auction
3521338,500,220,174,122,60,62,274,Auction
3521438,275,95,74,155,95,60,74,Auction
3524046,1550,1100,340,325,275,50,540,Auction
3524153,575,265,230,335,260,75,505,Auction
3524932,1325,730,489,535,285,250,489,Auction
3525325,850,445,334,195,135,60,1184,Auction
3526125,2925,2375,440,145,85,60,515,Auction
3540720,6250,5205,754,2375,1895,480,3204,Auction
3545198,700,335,255,270,170,100,230,Auction
3544722,1125,730,285,115,55,60,460,Auction
3548633,1100,765,225,375,300,75,425,Auction
3539363,1575,1000,469,845,505,340,794,Auction
3539431,275,95,59,160,100,60,384,Auction
3540781,875,475,290,275,225,50,265,Auction
3528801,750,410,234,345,195,150,284,Auction
3518273,925,495,320,155,95,60,170,Auction
3528976,4200,3460,630,2455,1805,650,1930,Auction
3529019,275,60,104,55,30,25,79,Auction
3526618,2675,1995,570,1880,1280,600,1595,Auction
3530805,950,515,274,550,485,65,424,Auction
3533220,1900,1275,474,1155,755,400,474,Auction
3514879,725,385,185,190,130,60,110,Auction
3534499,2100,1620,374,65,45,20,3974,Auction
3500431,2750,2150,395,2065,1415,650,895,Auction
3504777,1000,580,314,200,100,100,314,Auction
3507149,575,290,175,325,250,75,225,Auction
3508119,2575,2030,439,1035,635,400,1664,Auction
3508126,600,270,224,205,105,100,1124,Auction
3509991,350,135,90,155,120,35,190,Auction
3539258,1300,840,280,545,325,220,330,Auction
3540593,675,285,284,250,200,50,209,Auction
3526805,800,470,224,395,245,150,424,Auction
3527460,500,215,175,145,110,35,250,Auction
3530468,400,215,79,150,115,35,104,Auction
3494070,1050,640,244,410,355,55,594,Auction
3532901,750,430,175,185,125,60,525,Auction
3533646,925,495,320,190,130,60,945,Auction
3534382,1250,835,305,1000,600,400,305,Auction
3534020,2675,2075,465,885,545,340,1940,Auction
3541823,500,220,174,125,90,35,274,Auction
3543563,350,100,140,85,60,25,215,Auction
3499995,525,240,140,255,155,100,465,Auction
3459292,1300,780,334,665,425,240,634,Auction
3512663,1700,1240,354,1090,690,400,2254,Auction
3514601,1500,935,365,880,540,340,415,Auction
3515271,925,565,250,190,155,35,200,Auction
3515816,350,115,104,90,65,25,454,Auction
3516273,875,455,310,180,145,35,160,Auction
3516309,1075,715,254,515,265,250,779,Auction
3516373,500,215,175,120,60,60,150,Auction
3517645,650,270,210,250,150,100,135,Auction
3546154,775,410,205,350,200,150,230,Auction
3546572,725,355,249,330,180,150,249,Auction
3535586,1275,860,249,500,375,125,474,Auction
3536496,750,405,235,245,210,35,685,Auction
3536889,650,335,209,80,55,25,109,Auction
3540483,1200,755,335,480,260,220,1331.37,Auction
3542487,975,630,239,180,145,35,114,Auction
3543030,650,365,140,190,145,45,140,Auction
3547771,400,165,125,75,50,25,300,Auction
3532454,900,545,245,210,110,100,395,Auction
3534212,1000,675,215,300,225,75,765,Auction
3537101,750,430,179,270,220,50,179,Auction
3519817,2125,1540,479,1500,1000,500,354,Auction
3519951,950,535,249,190,155,35,649,Auction
3528382,350,120,120,125,65,60,120,Auction
3531083,925,510,280,585,335,250,105,Auction
3531447,1800,1330,360,935,565,370,406.62,Auction
3533121,675,375,194,410,355,55,319,Auction
3541243,500,175,215,124,90,34,165,Auction
3421920,1075,690,220,375,225,150,-130,Auction
3423756,300,85,105,110,50,60,155,Auction
3423992,500,250,110,250,200,50,85,Auction
3424963,1250,910,230,130,70,60,80,Auction
3425063,875,455,310,280,180,100,210,Auction
3425678,1525,1080,339,560,310,250,764,Auction
3422755,1200,635,365,395,245,150,140,Auction
3421283,475,195,174,200,150,50,349,Auction
3426449,1075,695,274,200,100,100,99,Auction
3426749,1300,780,414,270,220,50,-436,Auction
3426799,1350,950,290,700,545,155,190,Auction
3427000,600,315,175,180,145,35,-200,Auction
3428586,1000,625,215,215,125,90,65,Auction
3429007,1025,650,269,265,165,100,219,Auction
3430444,575,275,194,495,275,220,519,Auction
3406743,950,545,299,655,375,280,131.75,Auction
3432851,725,350,265,155,120,35,-185,Auction
3433687,1600,1070,424,970,600,370,424,Auction
3433951,1125,645,309,655,410,245,84,Auction
3436560,2275,1610,865,1085,685,400,140,Auction
3437496,1450,895,445,745,435,310,695,Auction
3438082,750,430,210,145,85,60,185,Auction
3438246,700,340,254,95,70,25,-96,Auction
3438381,2125,1515,500,1615,1065,550,775,Auction
3439417,1400,1055,239,1160,760,400,-61,Auction
3434537,550,245,199,160,140,20,49,Auction
3439967,575,305,135,500,250,250,560,Auction
3440053,500,230,149,165,130,35,49,Auction
3440068,1325,845,295,940,845,95,1470,Auction
3426985,975,485,329,505,255,250,329,Auction
3441154,625,300,199,20,10,10,-126,Auction
3443262,400,215,79,125,65,60,279,Auction
3444197,425,115,200,100,65,35,-25,Auction
3431394,750,370,219,199,155,44,224.71,Auction
3446169,600,270,214,190,170,20,-61,Auction
3446870,800,425,269,365,290,75,219,Auction
3447305,500,225,165,355,205,150,1160.45,Auction
3448592,375,70,199,20,10,10,74,Auction
3448627,425,140,175,200,100,100,1045.35,Auction
3448978,550,285,210,150,115,35,60,Auction
3449042,650,340,175,250,200,50,250,Auction
3449513,475,165,200,155,120,35,-25,Auction
3449527,925,525,294,350,275,75,294,Auction
3450463,925,350,259.37,205,155,50,1884.37,Auction
3450750,1050,610,334,285,185,100,384,Auction
3450814,2475,1975,394,1615,1065,550,419,Auction
3450900,875,505,264,450,230,220,89,Auction
3452385,1050,690,200,460,350,110,900,Auction
3452221,1750,1285,559,250,150,100,1009,Auction
3452922,975,610,259,875,535,340,784,Auction
3453272,625,285,230,125,65,60,305,Auction
3453822,625,300,175,245,195,50,50,Auction
3453872,550,270,194,50,25,25,144,Auction
3454022,525,245,174,205,105,100,249,Auction
3454243,525,240,175,245,195,50,175,Auction
3454258,1350,885,359,170,110,60,1309,Auction
3453607,1575,1155,250,710,400,310,1871.62,Auction
3434337,575,220,200,190,155,35,-150,Auction
3454843,1275,780,385,965,595,370,1110,Auction
3455344,425,115,200,70,45,25,175,Auction
3455543,425,140,175,60,35,25,150,Auction
3455680,1700,1155,439,600,320,280,2139,Auction
3456516,625,315,175,350,275,75,750,Auction
3456630,625,285,200,290,190,100,-75,Auction
3457902,1075,605,294,270,170,100,314.54,Auction
3430929,500,195,199,85,70,15,199,Auction
3460224,600,280,375,85,65,20,300,Auction
3460373,550,235,209,100,40,60,209,Auction
3461159,850,470,274,140,80,60,274,Auction
3463918,825,465,254,465,245,220,254,Auction
3464939,1950,1475,369,1110,710,400,1619,Auction
3465589,1075,710,255,560,310,250,105,Auction
3465875,1225,660,394,475,280,195,269,Auction
3466426,1000,675,215,300,150,150,765,Auction
3451886,550,265,174,165,105,60,174,Auction
3466775,675,355,214,250,200,50,164,Auction
3467312,475,190,200,155,95,60,-195,Auction
3466575,800,510,184,110,90,20,284,Auction
3463582,800,470,224,245,195,50,174,Auction
3468647,375,190,79,150,115,35,79,Auction
3469719,950,545,384,60,40,20,834,Auction
3469584,900,545,245,255,205,50,945,Auction
3468848,3100,2525,465,1705,1155,550,665,Auction
3471356,400,120,194,140,80,60,194,Auction
3435473,375,160,109,125,90,35,334,Auction
3471505,1000,625,330,695,375,320,330,Auction
3472241,925,570,199,335,185,150,674,Auction
3472141,1400,855,435,795,485,310,235,Auction
3473277,925,515,244,410,190,220,219,Auction
3473227,875,415,284,230,180,50,284,Auction
3473663,300,90,104,50,25,25,104,Auction
3222736,300,95,85,50,25,25,160,Auction
3474799,475,190,175,85,60,25,400,Auction
3475364,375,130,139,115,80,35,114,Auction
3447756,925,605,210,280,180,100,110,Auction
3476335,575,305,160,235,185,50,60,Auction
3476636,375,160,89,150,115,35,214,Auction
3476721,850,455,285,295,195,100,310,Auction
3476972,275,65,104,60,35,25,129,Auction
3477022,375,140,129,170,135,35,129,Auction
3477386,675,320,249,5,5,0,224,Auction
3477757,550,210,199,105,70,35,449,Auction
3478308,975,485,334,505,280,225,109,Auction
3478507,1525,960,369,1155,755,400,394,Auction
3478757,1025,670,245,755,445,310,920,Auction
3477807,1200,640,364,460,240,220,289,Auction
3473142,250,70,55,80,55,25,230,Auction
3479258,950,545,239,340,265,75,239,Auction
3479779,575,250,215,200,150,50,740,Auction
3480029,725,350,265,255,205,50,165,Auction
3480715,1450,1065,275,385,310,75,675,Auction
3481951,575,255,214,80,55,25,214,Auction
3483788,650,350,175,310,160,150,-150,Auction
3485710,1250,675,465,470,250,220,365,Auction
3419311,600,320,174,125,90,35,174,Auction
3488804,575,295,174,200,100,100,499,Auction
3489253,625,335,184,120,85,35,9,Auction
3489940,600,315,145,245,205,40,466.62,Auction
3491526,1150,815,229,197,135,62,479,Auction
3491511,2750,2150,395,435,215,220,245,Auction
3492062,1225,715,665,615,335,280,790,Auction
3492648,1200,815,330,820,480,340,230,Auction
3436960,1450,895,449,1265,815,450,599,Auction
3461296,400,185,85,250,150,100,485,Auction
3484909,1825,1115,600,620,340,280,425,Auction
3490676,550,260,180,200,150,50,355,Auction
3494919,550,235,204,10,5,5,354,Auction
3495405,225,45,60,65,40,25,385,Auction
3495605,850,465,275,210,110,100,300,Auction
3497827,500,190,200,125,90,35,175,Auction
3498178,1425,985,330,445,225,220,455,Auction
3498664,650,350,190,250,150,100,390,Auction
3498963,700,340,224,320,170,150,324,Auction
3498999,900,550,244,225,125,100,344,Auction
3499599,425,115,200,150,90,60,325,Auction
3500085,1375,945,320,165,130,35,595,Auction
3501286,675,390,179,335,185,150,304,Auction
3501322,275,115,50,100,65,35,50,Auction
3501871,500,195,199,135,75,60,599,Auction
3503694,750,430,190,250,150,100,190,Auction
3505966,900,525,269,260,160,100,119,Auction
3509595,950,490,350,185,125,60,650,Auction
3511031,400,150,144,135,100,35,169,Auction
3514439,1575,1200,265,590,340,250,890,Auction
3507252,875,525,195,660,380,280,770,Auction
3497141,350,120,115,135,0,135,115,Auction
3516212,700,350,244,220,170,50,394,Auction
3516597,400,170,124,135,100,35,124,Auction
3517847,1000,675,215,275,175,100,315,Auction
3496641,350,115,104,140,105,35,154,Auction
3519756,375,125,140,35,15,20,215,Auction
3518334,1175,680,310,865,525,340,435,Auction
3518669,525,240,175,285,235,50,225,Auction
3515675,1500,1060,269,555,305,250,219,Auction
3521977,1050,670,274,335,185,150,1124,Auction
3522763,600,315,175,155,135,20,50,Auction
3521627,550,285,125,85,65,20,1425,Auction
3525486,1475,985,380,1005,605,400,155,Auction
3525585,925,495,320,400,180,220,120,Auction
3527808,350,150,90,155,135,20,240,Auction
3530502,500,190,200,97,75,22,300,Auction
3530452,500,215,175,125,90,35,600,Auction
3531987,525,240,175,97,75,22,150,Auction
3535867,700,370,220,185,150,35,345,Auction
